,word_text,word_count_zminka,word_count_zminka_rel,word_count_zminka_nerel,word_zminka_rank,word_zminka_rank_rel,word_zminka_rank_nerel
0,jaderne,1759,1651,108,1,1,3
1,jadernych,938,900,38,2,2,131
2,jadernou,850,807,43,3,3,101
3,usa,793,717,76,4,4,15
4,let,714,612,102,5,7,4
5,rt,698,657,41,6,5,111
6,elektrarny,667,647,20,7,6,501
7,rusko,664,607,57,8,8,47
8,dnes,501,412,89,9,13,9
9,jaderna,494,459,35,10,10,160
10,zbrane,492,478,14,11,9,913
11,putin,488,438,50,12,11,69
12,jaderny,475,416,59,13,12,42
13,nema,469,377,92,14,14,8
14,ruska,440,369,71,15,15,21
15,lidi,415,300,115,16,27,2
16,stejne,413,312,101,17,23,5
17,no,410,279,131,18,32,1
18,nebude,407,332,75,19,19,17
19,nikdo,399,306,93,20,25,6
20,nove,392,326,66,21,20,30
21,rusku,389,351,38,22,16,131
22,zemi,386,316,70,23,21,22
23,evrope,386,351,35,23,16,160
24,stat,358,304,54,25,26,54
25,bloku,354,340,14,26,18,913
26,pripade,351,283,68,27,31,26
27,roku,338,296,42,28,28,106
28,stale,337,272,65,29,36,32
29,cr,337,278,59,29,33,42
30,energie,334,308,26,31,24,302
31,vsechny,332,274,58,32,35,44
32,zeme,326,278,48,33,33,77
33,veci,322,260,62,34,37,37
34,elektraren,321,313,8,35,22,2491
35,navic,318,252,66,36,40,30
36,prvni,312,237,75,37,46,17
37,zbrani,311,284,27,38,30,277
38,opravdu,310,229,81,39,54,12
39,jaderneho,310,294,16,39,29,727
40,pouze,307,239,68,41,44,26
41,prave,307,240,67,41,42,28
42,vic,305,233,72,43,50,20
43,par,303,234,69,44,48,24
44,nato,302,256,46,45,38,84
45,nikdy,300,221,79,46,63,13
46,eu,299,248,51,47,41,65
47,meli,295,231,64,48,52,34
48,dobe,288,239,49,49,44,73
49,vse,286,234,52,50,48,60
50,zeman,283,200,83,51,70,10
51,velmi,282,229,53,52,54,57
52,nejaky,280,229,51,53,54,65
53,rakety,279,254,25,54,39,332
54,svete,277,228,49,55,57,73
55,problem,276,218,58,56,65,44
56,cele,270,227,43,57,59,101
57,statu,269,222,47,58,61,80
58,jasne,268,212,56,59,66,50
59,ruske,267,237,30,60,46,224
60,roce,266,227,39,61,59,122
61,valky,266,240,26,61,42,302
62,lide,265,202,63,63,69,36
63,uzemi,262,233,29,64,50,240
64,nejsou,260,210,50,65,67,69
65,rusove,258,228,30,66,57,224
66,at,258,181,77,66,79,14
67,drabova,257,228,29,68,57,240
68,valku,255,222,33,69,61,181
69,valka,254,221,33,70,63,181
70,vsech,241,197,44,71,71,96
71,vetsi,239,190,49,72,75,73
72,raket,233,206,27,73,68,277
73,nevim,228,162,66,74,94,30
74,statni,228,192,36,74,72,149
75,ruskem,226,191,35,76,74,160
76,nejvetsi,225,188,37,77,77,139
77,prezident,223,177,46,78,83,84
78,myslim,221,160,61,79,97,39
79,nejen,220,165,55,80,91,52
80,delat,215,158,57,81,100,47
81,rekl,213,166,47,82,88,80
82,smlouvy,212,185,27,83,78,277
83,jine,211,154,57,85,107,47
84,mela,211,166,45,85,88,90
85,fakt,211,147,64,85,124,34
86,teto,210,178,32,87,81,193
87,posledni,207,156,51,89,104,65
88,novych,207,192,15,89,72,809
89,ovsem,207,168,39,89,86,122
90,mozne,205,160,45,92,97,90
91,nyni,205,160,45,92,97,90
92,presne,205,149,56,92,119,50
93,dalsich,204,165,39,94,91,122
94,vlastni,203,157,46,96,102,84
95,sam,203,143,60,96,131,40
96,zdroje,203,189,14,96,76,913
97,elektriny,198,178,20,98,81,501
98,jadernym,197,179,18,99,80,605
99,sveta,197,171,26,99,85,302
100,svet,196,163,33,102,93,181
101,pan,196,120,76,102,185,15
102,kolem,196,152,44,102,112,96
103,letech,195,157,38,105,102,131
104,misto,195,144,51,105,128,65
105,evropy,195,165,30,105,91,224
106,da,195,146,49,105,126,73
107,velke,194,160,34,108,97,171
108,clovek,194,125,69,108,169,24
109,staci,192,147,45,110,124,90
110,penize,192,153,39,110,110,122
111,prezidenta,191,166,25,112,88,332
112,nuklearni,190,121,69,113,181,24
113,lepsi,189,129,60,114,158,40
114,strany,188,136,52,115,140,60
115,radioaktivni,186,133,53,116,148,57
116,ceske,185,158,27,117,100,277
117,jiste,185,150,35,117,116,160
118,vlada,184,161,23,119,95,391
119,rozdil,182,132,50,120,152,69
120,bloky,181,177,4,122,83,6130
121,mimo,181,150,31,122,116,207
122,valce,181,143,38,122,131,131
123,naopak,180,146,34,124,126,171
124,soucasne,180,154,26,124,107,302
125,nemuze,178,131,47,126,155,80
126,staty,178,153,25,126,110,332
127,podobne,177,143,34,128,131,171
128,skutecne,176,132,44,129,152,96
129,pane,176,125,51,129,169,65
130,predevsim,174,148,26,131,121,302
131,dela,174,126,48,131,165,77
132,jadro,173,153,20,133,110,501
133,melo,173,133,40,133,148,115
134,rika,172,117,55,135,203,52
135,cenu,171,134,37,137,144,139
136,nekolik,171,150,21,137,116,459
137,rok,171,142,29,137,134,240
138,cas,170,127,43,139,161,101
139,utok,170,147,23,139,124,391
140,nebudou,167,125,42,142,169,106
141,zadne,167,137,30,142,137,224
142,naprosto,167,121,46,142,181,84
143,trochu,166,116,50,146,207,69
144,hned,166,120,46,146,185,84
145,zareni,166,156,10,146,104,1614
146,rad,166,104,62,146,250,37
147,cely,166,132,34,146,152,171
148,zdroj,165,136,29,149,140,240
149,pomoci,165,126,39,149,165,122
150,oblasti,164,138,26,152,136,302
151,dlouho,164,111,53,152,226,57
152,energii,164,149,15,152,119,809
153,uhli,163,152,11,154,112,1363
154,miliard,163,148,15,154,121,809
155,dana,162,154,8,157,107,2491
156,tolik,162,119,43,157,190,101
157,bezpecnost,162,151,11,157,114,1363
158,zemana,162,137,25,157,137,332
159,jineho,161,125,36,160,169,149
160,cez,161,150,11,160,116,1363
161,vlady,160,124,36,162,172,149
162,mysli,159,119,40,163,190,115
163,nebylo,158,122,36,164,177,149
164,stoji,157,134,23,166,144,391
165,rusky,157,126,31,166,165,207
166,pritom,157,127,30,166,161,224
167,postavit,156,134,22,168,144,424
168,pise,154,122,32,170,177,193
169,novy,154,118,36,170,198,149
170,prece,154,117,37,170,203,139
171,napriklad,153,134,19,173,144,546
172,vi,153,115,38,173,213,131
173,cim,153,114,39,173,217,122
174,nekdy,153,114,39,173,217,122
175,udelat,152,121,31,176,181,207
176,pry,151,118,33,177,198,181
177,hrozi,150,143,7,179,131,3140
178,americke,150,134,16,179,144,727
179,celou,150,119,31,179,190,207
180,putina,149,121,28,183,181,257
181,americkych,149,132,17,183,152,666
182,vcetne,149,116,33,183,207,181
183,slova,149,123,26,183,173,302
184,noveho,149,118,31,183,198,207
185,zivot,148,116,32,186,207,193
186,nasledne,147,140,7,187,135,3140
187,nemecku,147,122,25,187,177,332
188,dukovany,146,144,2,191,128,10331
189,nejlepsi,146,113,33,191,219,181
190,nejde,146,109,37,191,231,139
191,bychom,146,128,18,191,159,605
192,deti,146,103,43,191,253,101
193,nakonec,145,113,32,196,219,193
194,system,145,108,37,196,234,139
195,mnohem,145,110,35,196,229,160
196,praci,145,118,27,196,198,277
197,rozhodne,145,122,23,196,177,391
198,snazi,144,105,39,199,246,122
199,situace,144,112,32,199,222,193
200,tuto,143,111,32,201,226,193
201,jadernymi,143,134,9,201,144,1924
202,zdroju,142,123,19,204,173,546
203,clanek,142,111,31,204,226,207
204,pani,142,90,52,204,325,60
205,dobu,141,115,26,207,213,302
206,svem,141,112,29,207,222,240
207,mnozstvi,141,102,39,207,256,122
208,doslo,141,108,33,207,234,181
209,doletu,140,122,18,211,177,605
210,prace,140,94,46,211,296,84
211,pravda,140,98,42,211,277,106
212,energetiky,139,136,3,216,140,7493
213,evropa,139,118,21,216,198,459
214,vyssi,139,108,31,216,234,207
215,stavet,139,131,8,216,155,2491
216,clanku,139,115,24,216,213,361
217,moznost,139,104,35,216,250,160
218,politiku,139,111,28,216,226,257
219,ruskych,138,119,19,222,190,546
220,chtel,138,94,44,222,296,96
221,znamena,138,112,26,222,222,302
222,rozhodnuti,138,108,30,222,234,224
223,reaktoru,138,127,11,222,161,1363
224,mnoho,137,100,37,225,265,139
225,cast,137,102,35,225,256,160
226,zadny,136,114,22,228,217,424
227,vladimir,136,119,17,228,190,666
228,znovu,136,94,42,228,296,106
229,davno,136,106,30,228,243,224
230,potreba,135,104,31,232,250,207
231,vystavbu,135,130,5,232,157,5101
232,vetsina,135,110,25,232,229,332
233,sami,135,94,41,232,296,111
234,vazne,134,89,45,238,332,90
235,milionu,134,102,32,238,256,193
236,moznosti,134,118,16,238,198,727
237,tem,134,95,39,238,288,122
238,prijde,134,94,40,238,296,115
239,stredniho,134,116,18,238,207,605
240,jiny,134,98,36,238,277,149
241,druhe,133,101,32,244,260,193
242,trump,133,119,14,244,190,913
243,jednu,133,107,26,244,239,302
244,temelin,133,127,6,244,161,4065
245,rijna,133,116,17,244,207,666
246,situaci,132,107,25,249,239,332
247,informace,132,99,33,249,270,181
248,odvetou,132,132,0,249,152,49779
249,re,132,87,45,249,347,90
250,ramci,132,90,42,249,325,106
251,elektrarnu,131,125,6,253,169,4065
252,cena,131,116,15,253,207,809
253,mohli,131,98,33,253,277,181
254,oboru,130,115,15,257,213,809
255,plynu,130,115,15,257,213,809
256,doby,130,99,31,257,270,207
257,cina,130,119,11,257,190,1363
258,sssr,130,112,18,257,222,605
259,babis,129,75,54,261,433,54
260,rekne,129,119,10,261,190,1614
261,jedine,129,97,32,261,283,193
262,zrovna,128,87,41,265,347,111
263,zrejme,128,106,22,265,243,424
264,oze,128,107,21,265,239,459
265,pana,128,98,30,265,277,224
266,radeji,128,86,42,265,355,106
267,svym,128,92,36,265,310,149
268,pravdu,127,86,41,270,355,111
269,velky,127,99,28,270,270,257
270,bud,127,102,25,270,256,332
271,nemecko,126,102,24,274,256,361
272,vec,126,94,32,274,296,193
273,nejakou,126,97,29,274,283,240
274,plest,126,118,8,274,198,2491
275,jaky,126,90,36,274,325,149
276,dnesni,126,90,36,274,325,149
277,duvod,125,88,37,279,339,139
278,spolecnosti,125,94,31,279,296,207
279,rosatom,125,120,5,279,185,5101
280,otazka,125,100,25,279,265,332
281,nejsem,124,72,52,284,462,60
282,stalo,124,94,30,284,296,224
283,mene,124,94,30,284,296,224
284,zadna,124,98,26,284,277,302
285,spis,124,88,36,284,339,149
286,muzeme,124,104,20,284,250,501
287,konecne,123,87,36,289,347,149
288,celkem,123,98,25,289,277,332
289,roky,123,93,30,289,304,224
290,sem,123,79,44,289,396,96
291,vojenske,122,93,29,294,304,240
292,prakticky,122,93,29,294,304,240
293,reseni,122,100,22,294,265,424
294,spatne,122,83,39,294,368,122
295,fyzika,122,107,15,294,239,809
296,primo,120,100,20,297,265,501
297,firmy,120,99,21,297,270,459
298,duvodu,119,91,28,300,318,257
299,jadra,119,108,11,300,234,1363
300,elektrarna,119,117,2,300,203,10331
301,americane,118,98,20,304,277,501
302,velka,118,92,26,304,310,302
303,videt,118,96,22,304,286,424
304,mohla,118,91,27,304,318,277
305,klidne,118,91,27,304,318,277
306,nasich,117,99,18,308,270,605
307,vsem,117,83,34,308,368,171
308,neustale,117,96,21,308,286,459
309,svetove,116,84,32,310,364,193
310,dostavbu,115,108,7,312,234,3140
311,zahranici,115,81,34,312,381,171
312,moci,115,87,28,312,347,257
313,systemu,115,81,34,312,381,171
314,tvrdi,114,87,27,317,347,277
315,muset,114,96,18,317,286,605
316,okoli,114,92,22,317,310,424
317,lety,114,86,28,317,355,257
318,mimochodem,114,95,19,317,288,546
319,typu,113,90,23,321,325,391
320,spravne,113,80,33,321,388,181
321,dvou,113,82,31,321,375,207
322,ziskala,112,101,11,323,260,1363
323,technologie,111,101,10,324,260,1614
324,utoku,110,98,12,327,277,1179
325,souhlasim,110,86,24,327,355,361
326,vzhledem,110,91,19,327,318,546
327,blok,110,91,19,327,318,546
328,pote,110,85,25,327,360,332
329,nechce,109,78,31,331,407,207
330,senat,109,16,93,331,3019,6
331,informaci,109,91,18,331,318,605
332,ceny,109,85,24,331,360,361
333,cesta,108,78,30,337,407,224
334,temer,108,88,20,337,339,501
335,zbranemi,108,94,14,337,296,913
336,americky,108,91,17,337,318,666
337,smysl,108,87,21,337,347,459
338,podstate,108,88,20,337,339,501
339,nemecka,108,94,14,337,296,913
340,cela,107,79,28,345,396,257
341,vystudovala,107,105,2,345,246,10331
342,fakultu,107,106,1,345,243,20221
343,napsal,107,73,34,345,451,171
344,elektrinu,107,100,7,345,265,3140
345,fyzikalne,107,106,1,345,243,20221
346,volby,107,43,64,345,952,34
347,rychle,107,82,25,345,375,332
348,vedeni,107,81,26,345,381,302
349,smlouvu,106,91,15,350,318,809
350,domu,105,76,29,354,425,240
351,stranu,105,73,32,354,451,193
352,odpadu,105,101,4,354,260,6130
353,horsi,105,82,23,354,375,391
354,mezinarodni,105,89,16,354,332,727
355,slo,105,78,27,354,407,277
356,hlavni,105,83,22,354,368,424
357,inzenyrskou,104,104,0,360,250,49779
358,nazor,104,81,23,360,381,391
359,vim,104,73,31,360,451,207
360,ciny,104,92,12,360,310,1179
361,tema,104,78,26,360,407,302
362,vsude,104,75,29,360,433,240
363,zacit,103,88,15,368,339,809
364,viz,103,79,24,368,396,361
365,mohlo,103,91,12,368,318,1179
366,chvili,103,75,28,368,433,257
367,dostal,103,55,48,368,680,77
368,cloveka,103,79,24,368,396,361
369,vody,103,65,38,368,535,131
370,politiky,103,77,26,368,417,302
371,druhou,103,78,25,368,407,332
372,muzete,102,76,26,374,425,302
373,zapad,102,81,21,374,381,459
374,casto,102,67,35,374,511,160
375,prumyslu,102,94,8,374,296,2491
376,odstoupeni,101,87,14,379,347,913
377,takto,101,66,35,379,521,160
378,ceska,101,85,16,379,360,727
379,senatu,101,19,82,379,2518,11
380,konec,101,76,25,379,425,332
381,presto,100,77,23,385,417,391
382,sankce,100,82,18,385,375,605
383,nutne,100,78,22,385,407,424
384,delaji,100,78,22,385,407,424
385,cvut,100,98,2,385,277,10331
386,vede,100,74,26,385,442,302
387,hodin,100,77,23,385,417,391
388,republiky,99,73,26,392,451,302
389,plne,99,87,12,392,347,1179
390,problemy,99,88,11,392,339,1363
391,boji,99,77,22,392,417,424
392,chteli,99,65,34,392,535,171
393,vyroby,99,75,24,392,433,361
394,zpusobem,99,79,20,392,396,501
395,dohody,98,71,27,400,474,277
396,lepe,98,71,27,400,474,277
397,vypada,98,61,37,400,593,139
398,stoleti,98,72,26,400,462,302
399,nejvyssi,98,80,18,400,388,605
400,ohledne,98,77,21,400,417,459
401,skutecnosti,98,83,15,400,368,809
402,sobe,98,69,29,400,492,240
403,zmrd,98,92,6,400,310,4065
404,nekolika,98,75,23,400,433,391
405,vaclavagh,97,97,0,408,283,49779
406,evropske,97,83,14,408,368,913
407,treti,97,72,25,408,462,332
408,nelze,97,89,8,408,332,2491
409,dat,97,70,27,408,484,277
410,moznou,96,93,3,416,304,7493
411,naklady,96,87,9,416,347,1924
412,sebou,96,75,21,416,433,459
413,nemci,96,87,9,416,347,1924
414,ruznych,96,67,29,416,511,240
415,obdobi,96,76,20,416,425,501
416,vyvoj,96,85,11,416,360,1363
417,lidem,96,64,32,416,548,193
418,miste,96,73,23,416,451,391
419,km,96,82,14,416,375,913
420,drive,96,79,17,416,396,666
421,titul,95,92,3,424,310,7493
422,verejne,95,64,31,424,548,207
423,zapadni,95,79,16,424,396,727
424,vime,95,80,15,424,388,809
425,plyn,95,83,12,424,368,1179
426,obrany,94,74,20,431,442,501
427,studiu,94,94,0,431,296,49779
428,silne,94,73,21,431,451,459
429,ktereho,94,64,30,431,548,224
430,pripadne,94,75,19,431,433,546
431,pouzit,94,85,9,431,360,1924
432,dokud,94,72,22,431,462,424
433,spolecnost,94,77,17,431,417,666
434,nevi,94,71,23,431,474,391
435,aplikace,93,92,1,439,310,20221
436,jednoho,93,62,31,439,575,207
437,radu,93,74,19,439,442,546
438,tyce,93,74,19,439,442,546
439,resit,93,68,25,439,502,332
440,zapadu,93,68,25,439,502,332
441,vyrobu,93,72,21,439,462,459
442,obor,93,89,4,439,332,6130
443,casu,92,71,21,449,474,459
444,vzdyt,92,64,28,449,548,257
445,prohlasil,92,68,24,449,502,361
446,provozu,92,86,6,449,355,4065
447,zarizeni,92,78,14,449,407,913
448,tzv,92,68,24,449,502,361
449,takovou,92,70,22,449,484,424
450,ministr,92,77,15,449,417,809
451,ods,92,19,73,449,2518,19
452,odpoved,92,69,23,449,492,391
453,armady,92,65,27,449,535,277
454,nicmene,91,73,18,456,451,605
455,souhlasit,91,80,11,456,388,1363
456,konci,91,68,23,456,502,391
457,ionizujiciho,91,90,1,456,325,20221
458,dozimetrie,90,89,1,462,332,20221
459,nazoru,90,77,13,462,417,1036
460,videl,90,62,28,462,575,257
461,odpad,90,71,19,462,474,546
462,nova,90,71,19,462,474,546
463,osobne,90,76,14,462,425,913
464,zacal,90,66,24,462,521,361
465,mluvit,90,69,21,462,492,459
466,vetsinou,89,66,23,473,521,391
467,rady,89,76,13,473,425,1036
468,nemusi,89,75,14,473,433,913
469,komu,89,69,20,473,492,501
470,hlediska,89,68,21,473,502,459
471,nejaka,89,55,34,473,680,171
472,likvidaci,89,71,18,473,474,605
473,nemam,89,53,36,473,715,149
474,phd,89,89,0,473,332,49779
475,venovala,89,89,0,473,332,49779
476,udajne,89,68,21,473,502,459
477,penez,89,69,20,473,492,501
478,doma,89,63,26,473,560,302
479,reaktory,88,85,3,483,360,7493
480,sil,88,66,22,483,521,424
481,prostredi,88,78,10,483,407,1614
482,doktorskemu,88,88,0,483,339,49779
483,nekoho,88,58,30,483,633,224
484,miru,88,75,13,483,433,1036
485,stavbu,88,81,7,483,381,3140
486,branit,87,80,7,493,388,3140
487,musel,87,59,28,493,619,257
488,neda,87,63,24,493,560,361
489,zmenit,87,58,29,493,633,240
490,pouziti,87,74,13,493,442,1036
491,cestu,87,66,21,493,521,459
492,pohrozil,87,83,4,493,368,6130
493,technologii,87,81,6,493,381,4065
494,podminky,87,63,24,493,560,361
495,jinde,87,64,23,493,548,391
496,reakci,87,71,16,493,474,727
497,konfliktu,87,80,7,493,388,3140
498,deje,87,77,10,493,417,1614
499,francie,86,81,5,504,381,5101
500,sily,86,68,18,504,502,605
501,krize,86,70,16,504,484,727
502,dostat,86,56,30,504,664,224
503,urovni,86,61,25,504,593,332
504,celem,86,79,7,504,396,3140
505,casti,86,68,18,504,502,605
506,stavu,86,74,12,504,442,1179
507,nem,86,62,24,504,575,361
508,ekonomicky,85,67,18,512,511,605
509,pozdeji,85,76,9,512,425,1924
510,slunce,85,62,23,512,575,391
511,strane,85,62,23,512,575,391
512,tou,85,59,26,512,619,302
513,problemu,85,72,13,512,462,1036
514,teprve,85,62,23,512,575,391
515,hrad,85,72,13,512,462,1036
516,evropu,84,70,14,521,484,913
517,slovo,84,60,24,521,606,361
518,paliva,84,79,5,521,396,5101
519,obyvatel,84,60,24,521,606,361
520,rizeni,84,61,23,521,593,391
521,politicky,84,65,19,521,535,546
522,zivota,84,57,27,521,648,277
523,cilem,84,78,6,521,407,4065
524,jit,84,46,38,521,867,131
525,oproti,83,63,20,531,560,501
526,stavbe,83,79,4,531,396,6130
527,zakladni,83,62,21,531,575,459
528,uhelne,83,83,0,531,368,49779
529,nekteri,83,62,21,531,575,459
530,otazku,83,62,21,531,575,459
531,energetiku,83,75,8,531,433,2491
532,spojene,83,70,13,531,484,1036
533,elektrina,83,78,5,531,407,5101
534,osn,83,72,11,531,462,1363
535,stovky,83,69,14,531,492,913
536,brat,83,64,19,531,548,546
537,nikoho,82,51,31,545,751,207
538,zadnou,82,65,17,545,535,666
539,velkou,82,64,18,545,548,605
540,jedne,82,64,18,545,548,605
541,lidstvo,82,68,14,545,502,913
542,minimalne,82,71,11,545,474,1363
543,ruskym,82,71,11,545,474,1363
544,nejspis,82,58,24,545,633,361
545,generace,82,61,21,545,593,459
546,vedet,82,52,30,545,730,224
547,zmeny,82,65,17,545,535,666
548,druhy,82,54,28,545,697,257
549,vidim,82,48,34,545,813,171
550,vliv,82,62,20,545,575,501
551,projektu,82,71,11,545,474,1363
552,palivo,81,74,7,556,442,3140
553,pravo,81,68,13,556,502,1036
554,zacne,81,60,21,556,606,459
555,politici,81,61,20,556,593,501
556,existuje,81,61,20,556,593,501
557,mensi,81,64,17,556,548,666
558,kratkeho,81,65,16,556,535,727
559,cesko,81,73,8,556,451,2491
560,plati,80,60,20,566,606,501
561,stal,80,61,19,566,593,546
562,nejvice,80,58,22,566,633,424
563,pocet,80,72,8,566,462,2491
564,stane,80,73,7,566,451,3140
565,dolaru,80,67,13,566,511,1036
566,zkusenosti,80,71,9,566,474,1924
567,pul,80,52,28,566,730,257
568,cesky,80,62,18,566,575,605
569,vytvoreni,80,70,10,566,484,1614
570,platit,80,65,15,566,535,809
571,zit,80,53,27,566,715,277
572,budoucnost,79,62,17,573,575,666
573,rozmistenim,78,72,6,578,462,4065
574,mluvi,78,59,19,578,619,546
575,dava,78,69,9,578,492,1924
576,dneska,78,49,29,578,786,240
577,patri,78,53,25,578,715,332
578,globalni,78,72,6,578,462,4065
579,bezpecnostni,78,68,10,578,502,1614
580,souvislosti,78,62,16,578,575,727
581,praze,78,43,35,578,952,160
582,podporu,78,66,12,578,521,1179
583,hlavice,77,72,5,587,462,5101
584,pohledu,77,56,21,587,664,459
585,nikoliv,77,63,14,587,560,913
586,vedci,77,66,11,587,521,1363
587,cestou,77,51,26,587,751,302
588,media,77,54,23,587,697,391
589,politicke,77,54,23,587,697,391
590,schopen,76,66,10,598,521,1614
591,ukrajiny,76,60,16,598,606,727
592,ministryne,76,69,7,598,492,3140
593,smerem,76,59,17,598,619,666
594,jadernem,76,66,10,598,521,1614
595,ukrajina,76,58,18,598,633,605
596,uradu,76,74,2,598,442,10331
597,udalosti,76,53,23,598,715,391
598,auta,76,64,12,598,548,1179
599,ps,76,38,38,598,1106,131
600,nahodou,76,56,20,598,664,501
601,nahradit,76,66,10,598,521,1614
602,obcanu,76,58,18,598,633,605
603,bomby,76,64,12,598,548,1179
604,myslite,76,54,22,598,697,424
605,prostredky,76,65,11,598,535,1363
606,stavi,75,66,9,611,521,1924
607,energetika,75,72,3,611,462,7493
608,temi,75,61,14,611,593,913
609,nikde,75,47,28,611,842,257
610,nazory,75,52,23,611,730,391
611,dni,75,57,18,611,648,605
612,more,75,56,19,611,664,546
613,snaha,75,65,10,611,535,1614
614,dosud,75,66,9,611,521,1924
615,ruskeho,74,60,14,621,606,913
616,obou,74,62,12,621,575,1179
617,zejmena,74,61,13,621,593,1036
618,rf,74,65,9,621,535,1924
619,cesku,74,63,11,621,560,1363
620,srovnani,74,62,12,621,575,1179
621,syrii,74,58,16,621,633,727
622,doufam,74,54,20,621,697,501
623,mir,74,55,19,621,680,546
624,ukrajine,74,52,22,621,730,424
625,kazdeho,74,57,17,621,648,666
626,hlavy,74,49,25,621,786,332
627,pohled,73,46,27,631,867,277
628,zbytecne,73,49,24,631,786,361
629,statniho,73,67,6,631,511,4065
630,musime,73,56,17,631,664,666
631,ziskat,73,59,14,631,619,913
632,zbran,73,60,13,631,606,1036
633,raji,73,55,18,631,680,605
634,jiri,72,47,25,641,842,332
635,udelal,72,47,25,641,842,332
636,dlouhodobe,72,62,10,641,575,1614
637,skoda,72,51,21,641,751,459
638,prohlaseni,72,53,19,641,715,546
639,kremlu,72,52,20,641,730,501
640,reaktor,72,66,6,641,521,4065
641,male,72,60,12,641,606,1179
642,energetice,72,70,2,641,484,10331
643,dne,72,54,18,641,697,605
644,program,72,57,15,641,648,809
645,mesta,72,61,11,641,593,1363
646,skupiny,72,54,18,641,697,605
647,ukrajinu,72,51,21,641,751,459
648,dusledku,71,54,17,654,697,666
649,americka,71,59,12,654,619,1179
650,zhruba,71,62,9,654,575,1924
651,ukol,71,58,13,654,633,1036
652,korun,71,67,4,654,511,6130
653,armada,71,62,9,654,575,1924
654,rict,71,52,19,654,730,546
655,zacina,71,51,20,654,751,501
656,dulezite,71,52,19,654,730,546
657,mely,71,55,16,654,680,727
658,site,71,64,7,654,548,3140
659,naseho,70,58,12,666,633,1179
660,minulosti,70,54,16,666,697,727
661,maly,70,43,27,666,952,277
662,dokaze,70,42,28,666,984,257
663,zniceni,70,55,15,666,680,809
664,michalsnobr,70,69,1,666,492,20221
665,hlavnim,70,63,7,666,560,3140
666,zajem,70,48,22,666,813,424
667,bezpecnosti,70,59,11,666,619,1363
668,poslednich,70,57,13,666,648,1036
669,ruzne,70,52,18,666,730,605
670,desitky,70,56,14,666,664,913
671,realne,70,56,14,666,664,913
672,prava,70,46,24,666,867,361
673,projekt,69,63,6,679,560,4065
674,pomoc,69,56,13,679,664,1036
675,rada,69,56,13,679,664,1036
676,velice,69,56,13,679,664,1036
677,meho,69,51,18,679,751,605
678,obeti,69,55,14,679,680,913
679,rusy,69,59,10,679,619,1614
680,solarni,69,64,5,679,548,5101
681,cili,69,58,11,679,633,1363
682,hrade,69,65,4,679,535,6130
683,procent,69,57,12,679,648,1179
684,nesmysl,69,54,15,679,697,809
685,psal,68,43,25,691,952,332
686,spolecne,68,49,19,691,786,546
687,us,68,59,9,691,619,1924
688,potrebuje,68,45,23,691,898,391
689,skoly,68,40,28,691,1042,257
690,miliardy,68,55,13,691,680,1036
691,chapu,68,42,26,691,984,302
692,krymu,68,48,20,691,813,501
693,lodi,68,53,15,691,715,809
694,tezko,68,59,9,691,619,1924
695,ukazuje,68,56,12,691,664,1179
696,tezke,68,48,20,691,813,501
697,slov,67,41,26,704,1012,302
698,zacatku,67,48,19,704,813,546
699,dukovanech,67,66,1,704,521,20221
700,inf,67,62,5,704,575,5101
701,cernobylu,67,62,5,704,575,5101
702,volbach,67,38,29,704,1106,240
703,okamzite,67,55,12,704,680,1179
704,zpet,67,53,14,704,715,913
705,dali,67,49,18,704,786,605
706,jedina,67,49,18,704,786,605
707,cviceni,67,54,13,704,697,1036
708,zivotnost,67,64,3,704,548,7493
709,hlavu,67,41,26,704,1012,302
710,uderu,66,55,11,719,680,1363
711,budeli,66,65,1,719,535,20221
712,narodni,66,49,17,719,786,666
713,pravdepodobne,66,61,5,719,593,5101
714,dalo,66,45,21,719,898,459
715,dodnes,66,51,15,719,751,809
716,formou,66,60,6,719,606,4065
717,poctu,66,51,15,719,751,809
718,driv,66,38,28,719,1106,257
719,trumpa,66,62,4,719,575,6130
720,doba,66,51,15,719,751,809
721,novakova,66,60,6,719,606,4065
722,mesice,66,42,24,719,984,361
723,nebudu,66,53,13,719,715,1036
724,nemeli,66,51,15,719,751,809
725,bojovat,66,49,17,719,786,666
726,historii,66,54,12,719,697,1179
727,moskvy,66,40,26,719,1042,302
728,vystavby,65,61,4,736,593,6130
729,letu,65,56,9,736,664,1924
730,amici,65,46,19,736,867,546
731,ministerstvo,65,48,17,736,813,666
732,otazky,65,48,17,736,813,666
733,politice,65,52,13,736,730,1036
734,zajmy,65,42,23,736,984,391
735,zajmu,65,63,2,736,560,10331
736,tym,65,57,8,736,648,2491
737,zapade,65,46,19,736,867,546
738,tyka,65,48,17,736,813,666
739,ceskych,65,58,7,736,633,3140
740,vychode,65,49,16,736,786,727
741,novou,65,52,13,736,730,1036
742,zastavit,65,51,14,736,751,913
743,budoucnosti,64,60,4,757,606,6130
744,najednou,64,53,11,757,715,1363
745,zakon,64,40,24,757,1042,361
746,uloziste,64,60,4,757,606,6130
747,vsechna,64,40,24,757,1042,361
748,tyden,64,46,18,757,867,605
749,abychom,64,58,6,757,633,4065
750,britanie,64,60,4,757,606,6130
751,rocne,64,58,6,757,633,4065
752,andrej,64,56,8,757,664,2491
753,neumi,64,45,19,757,898,546
754,autor,64,54,10,757,697,1614
755,mnoha,64,43,21,757,952,459
756,zajimave,64,48,16,757,813,727
757,vybuchu,64,53,11,757,715,1363
758,narod,64,38,26,757,1106,302
759,predstavit,64,46,18,757,867,605
760,hezky,64,40,24,757,1042,361
761,nemela,64,56,8,757,664,2491
762,vyroba,64,51,13,757,751,1036
763,vysledek,64,45,19,757,898,546
764,bures,64,7,57,757,7246,47
765,umi,64,39,25,757,1075,332
766,ruskou,64,49,15,757,786,809
767,vojaku,64,55,9,757,680,1924
768,organizace,64,49,15,757,786,809
769,vyrobit,64,44,20,757,924,501
770,americkeho,63,47,16,780,842,727
771,okolo,63,54,9,780,697,1924
772,moskva,63,46,17,780,867,666
773,pocit,63,43,20,780,952,501
774,hranice,63,50,13,780,770,1036
775,hranic,63,51,12,780,751,1179
776,soudruzi,63,49,14,780,786,913
777,kc,63,58,5,780,633,5101
778,dostali,63,46,17,780,867,666
779,radi,63,47,16,780,842,727
780,temelina,63,60,3,780,606,7493
781,dane,63,44,19,780,924,546
782,oci,63,38,25,780,1106,332
783,jednat,63,48,15,780,813,809
784,jinou,63,45,18,780,898,605
785,zpusob,63,53,10,780,715,1614
786,cokoliv,63,43,20,780,952,501
787,vykon,63,57,6,780,648,4065
788,rici,63,51,12,780,751,1179
789,minut,62,48,14,797,813,913
790,dukovan,62,62,0,797,575,49779
791,urad,62,58,4,797,633,6130
792,setkani,62,45,17,797,898,666
793,nebezpeci,62,42,20,797,984,501
794,vitr,62,48,14,797,813,913
795,petr,62,51,11,797,751,1363
796,museli,62,44,18,797,924,605
797,celeho,62,53,9,797,715,1924
798,ostatne,62,52,10,797,730,1614
799,smlouva,62,52,10,797,730,1614
800,nechteji,62,46,16,797,867,727
801,dojde,62,50,12,797,770,1179
802,mala,62,41,21,797,1012,459
803,zaklade,62,51,11,797,751,1363
804,poprve,61,34,27,817,1261,277
805,hranici,61,43,18,817,952,605
806,vesmiru,61,54,7,817,697,3140
807,americti,61,38,23,817,1106,391
808,jednim,61,54,7,817,697,3140
809,elektromobily,61,61,0,817,593,49779
810,nechapu,61,39,22,817,1075,424
811,severni,61,52,9,817,730,1924
812,pracovat,61,43,18,817,952,605
813,denne,61,41,20,817,1012,501
814,podstatne,61,54,7,817,697,3140
815,podivat,61,42,19,817,984,546
816,rozhodovat,61,57,4,817,648,6130
817,vyrabet,61,53,8,817,715,2491
818,stavba,61,55,6,817,680,4065
819,stav,61,50,11,817,770,1363
820,konkretne,61,46,15,817,867,809
821,utokem,61,54,7,817,697,3140
822,obecne,61,51,10,817,751,1614
823,resi,61,56,5,817,664,5101
824,rade,61,46,15,817,867,809
825,obyvatele,61,47,14,817,842,913
826,roli,61,48,13,817,813,1036
827,okolnosti,61,43,18,817,952,605
828,prisel,61,39,22,817,1075,424
829,dobra,60,43,17,840,952,666
830,zbytek,60,45,15,840,898,809
831,vsemi,60,45,15,840,898,809
832,zahranicni,60,48,12,840,813,1179
833,havarie,60,55,5,840,680,5101
834,strana,60,37,23,840,1137,391
835,jan,60,44,16,840,924,727
836,ekonomicke,60,39,21,840,1075,459
837,vyse,60,50,10,840,770,1614
838,jednani,60,48,12,840,813,1179
839,stavby,60,58,2,840,633,10331
840,vykonu,60,55,5,840,680,5101
841,znicit,60,57,3,840,648,7493
842,moskve,60,46,14,840,867,913
843,odzbrojovaci,60,59,1,840,619,20221
844,izrael,60,58,2,840,633,10331
845,strely,60,56,4,840,664,6130
846,pujde,60,43,17,840,952,666
847,kazdem,60,38,22,840,1106,424
848,valkou,60,49,11,840,786,1363
849,jehoz,60,48,12,840,813,1179
850,demokracie,60,34,26,840,1261,302
851,riziko,59,56,3,860,664,7493
852,jaka,59,48,11,860,813,1363
853,dostatecne,59,52,7,860,730,3140
854,rekla,59,52,7,860,730,3140
855,jakou,59,50,9,860,770,1924
856,sluzby,59,46,13,860,867,1036
857,vetsinu,59,45,14,860,898,913
858,premier,59,40,19,860,1042,546
859,financni,59,51,8,860,751,2491
860,tematem,59,58,1,860,633,20221
861,muzou,59,38,21,860,1106,459
862,ctzive,59,56,3,860,664,7493
863,trhu,59,48,11,860,813,1363
864,mistni,59,41,18,860,1012,605
865,video,59,41,18,860,1012,605
866,dluhu,59,57,2,860,648,10331
867,rikam,59,39,20,860,1075,501
868,tajne,58,49,9,879,786,1924
869,sanci,58,40,18,879,1042,605
870,iran,58,56,2,879,664,10331
871,tj,58,48,10,879,813,1614
872,vodu,58,46,12,879,867,1179
873,dispozici,58,48,10,879,813,1614
874,zacali,58,43,15,879,952,809
875,letadla,58,47,11,879,842,1363
876,voda,58,43,15,879,952,809
877,mista,58,47,11,879,842,1363
878,kazda,58,41,17,879,1012,666
879,vcera,58,41,17,879,1012,666
880,cist,58,47,11,879,842,1363
881,podil,58,54,4,879,697,6130
882,zabranit,58,50,8,879,770,2491
883,bezpecne,58,43,15,879,952,809
884,zbrojeni,58,57,1,879,648,20221
885,nechci,58,43,15,879,952,809
886,vyrazne,58,44,14,879,924,913
887,pekne,58,42,16,879,984,727
888,schopny,58,42,16,879,984,727
889,smrti,57,40,17,902,1042,666
890,prostrednictvim,57,47,10,902,842,1614
891,lidske,57,44,13,902,924,1036
892,verit,57,39,18,902,1075,605
893,federace,57,46,11,902,867,1363
894,politika,57,46,11,902,867,1363
895,obnovitelne,57,53,4,902,715,6130
896,pripad,57,47,10,902,842,1614
897,prvnim,57,45,12,902,898,1179
898,ciste,57,50,7,902,770,3140
899,preci,57,32,25,902,1352,332
900,priklad,57,50,7,902,770,3140
901,rusum,57,40,17,902,1042,666
902,reagovat,57,39,18,902,1075,605
903,osobni,57,40,17,902,1042,666
904,rusaci,57,50,7,902,770,3140
905,babise,57,34,23,902,1261,391
906,planete,57,44,13,902,924,1036
907,nejdrive,57,48,9,902,813,1924
908,parlamentu,57,45,12,902,898,1179
909,vedou,57,45,12,902,898,1179
910,planety,57,47,10,902,842,1614
911,planu,57,48,9,902,813,1924
912,myslel,57,29,28,902,1505,257
913,zije,57,45,12,902,898,1179
914,zakladny,57,48,9,902,813,1924
915,vest,56,43,13,925,952,1036
916,udela,56,42,14,925,984,913
917,normalni,56,45,11,925,898,1363
918,nemecke,56,48,8,925,813,2491
919,energeticke,56,48,8,925,813,2491
920,cinu,56,44,12,925,924,1179
921,relativne,56,48,8,925,813,2491
922,uroven,56,44,12,925,924,1179
923,uvedl,56,51,5,925,751,5101
924,nesouhlasim,56,47,9,925,842,1924
925,ct,56,43,13,925,952,1036
926,vojaci,56,37,19,925,1137,546
927,same,56,43,13,925,952,1036
928,zacalo,56,40,16,925,1042,727
929,proces,56,43,13,925,952,1036
930,vystavbe,56,54,2,925,697,10331
931,zasadni,56,39,17,925,1075,666
932,ruce,56,43,13,925,952,1036
933,syrie,56,38,18,925,1106,605
934,muz,56,36,20,925,1173,501
935,nejedly,55,51,4,947,751,6130
936,uder,55,47,8,947,842,2491
937,tlaci,55,46,9,947,867,1924
938,schopni,55,44,11,947,924,1363
939,ohledu,55,50,5,947,770,5101
940,konce,55,48,7,947,813,3140
941,zacnou,55,39,16,947,1075,727
942,spojenci,55,49,6,947,786,4065
943,neexistuje,55,51,4,947,751,6130
944,drzi,55,37,18,947,1137,605
945,chcipnou,55,45,10,947,898,1614
946,zivote,55,30,25,947,1449,332
947,obchodu,55,45,10,947,898,1614
948,rusu,55,41,14,947,1012,913
949,havarii,55,45,10,947,898,1614
950,ustavu,55,30,25,947,1449,332
951,raketach,55,42,13,947,984,1036
952,jednom,55,34,21,947,1261,459
953,nasledky,55,48,7,947,813,3140
954,rezimu,55,35,20,947,1214,501
955,vyjadreni,55,44,11,947,924,1363
956,budouci,55,45,10,947,898,1614
957,funguje,55,46,9,947,867,1924
958,vysvetlit,54,33,21,966,1310,459
959,zavislosti,54,53,1,966,715,20221
960,jede,54,37,17,966,1137,666
961,nemohou,54,52,2,966,730,10331
962,celkove,54,46,8,966,867,2491
963,pomalu,54,43,11,966,952,1363
964,nikomu,54,36,18,966,1173,605
965,vyvoje,54,43,11,966,952,1363
966,druha,54,44,10,966,924,1614
967,fazi,54,41,13,966,1012,1036
968,dotace,54,49,5,966,786,5101
969,nejakeho,54,36,18,966,1173,605
970,akce,54,47,7,966,842,3140
971,prisli,54,41,13,966,1012,1036
972,nesmi,54,36,18,966,1173,605
973,rozumi,54,29,25,966,1505,332
974,mohly,53,49,4,982,786,6130
975,konflikt,53,38,15,982,1106,809
976,prahy,53,30,23,982,1449,391
977,zmenu,53,39,14,982,1075,913
978,soucasti,53,47,6,982,842,4065
979,vodni,53,47,6,982,842,4065
980,lidstva,53,42,11,982,984,1363
981,obrovske,53,50,3,982,770,7493
982,vlade,53,45,8,982,898,2491
983,rovnou,53,44,9,982,924,1924
984,podminek,53,43,10,982,952,1614
985,ropy,53,51,2,982,751,10331
986,pochopitelne,53,45,8,982,898,2491
987,jinym,53,33,20,982,1310,501
988,nebe,53,37,16,982,1137,727
989,sit,53,35,18,982,1214,605
990,stejny,52,41,11,1004,1012,1363
991,nebezpecne,52,37,15,1004,1137,809
992,namorni,52,42,10,1004,984,1614
993,vadi,52,40,12,1004,1042,1179
994,zivotnosti,52,48,4,1004,813,6130
995,vojsk,52,31,21,1004,1395,459
996,nizsi,52,35,17,1004,1214,666
997,zlo,52,43,9,1004,952,1924
998,listopadu,52,42,10,1004,984,1614
999,snizeni,52,40,12,1004,1042,1179
1000,stran,52,30,22,1004,1449,424
1001,rust,52,42,10,1004,984,1614
1002,stredni,52,35,17,1004,1214,666
1003,zakazku,52,42,10,1004,984,1614
1004,dny,52,24,28,1004,1911,257
1005,prumysl,52,45,7,1004,898,3140
1006,naivne,52,51,1,1004,751,20221
1007,utoky,52,48,4,1004,813,6130
1008,leta,52,33,19,1004,1310,546
1009,nemohl,52,28,24,1004,1582,361
1010,vyuzit,52,36,16,1004,1173,727
1011,skutecnost,52,45,7,1004,898,3140
1012,zacala,52,42,10,1004,984,1614
1013,tvrde,52,28,24,1004,1582,361
1014,zbranich,52,51,1,1004,751,20221
1015,vztahu,52,33,19,1004,1310,546
1016,provoz,52,48,4,1004,813,6130
1017,pristich,51,47,4,1028,842,6130
1018,republice,51,37,14,1028,1137,913
1019,plan,51,46,5,1028,867,5101
1020,rozpadu,51,49,2,1028,786,10331
1021,rovnez,51,41,10,1028,1012,1614
1022,zeleni,51,48,3,1028,813,7493
1023,elektrarne,51,48,3,1028,813,7493
1024,zpravy,51,40,11,1028,1042,1363
1025,rezim,51,35,16,1028,1214,727
1026,rozpoctu,51,41,10,1028,1012,1614
1027,musim,51,35,16,1028,1214,727
1028,mori,51,43,8,1028,952,2491
1029,logicky,51,37,14,1028,1137,913
1030,francii,51,46,5,1028,867,5101
1031,miliony,51,45,6,1028,898,4065
1032,dostala,51,37,14,1028,1137,913
1033,zari,51,35,16,1028,1214,727
1034,rodina,51,26,25,1028,1729,332
1035,voleb,51,21,30,1028,2248,224
1036,obavy,51,42,9,1028,984,1924
1037,zivotni,51,35,16,1028,1214,727
1038,sujb,51,51,0,1028,751,49779
1039,musite,50,34,16,1053,1261,727
1040,zmrdi,50,50,0,1053,770,49779
1041,zprava,50,33,17,1053,1310,666
1042,expertni,50,50,0,1053,770,49779
1043,postavi,50,47,3,1053,842,7493
1044,stala,50,37,13,1053,1137,1036
1045,rusti,50,34,16,1053,1261,727
1046,vojensky,50,45,5,1053,898,5101
1047,poradku,50,36,14,1053,1173,913
1048,vyrabi,50,43,7,1053,952,3140
1049,boj,50,42,8,1053,984,2491
1050,prispevku,50,32,18,1053,1352,605
1051,chyba,50,22,28,1053,2135,257
1052,vyrobe,50,42,8,1053,984,2491
1053,psat,50,29,21,1053,1505,459
1054,udelali,50,40,10,1053,1042,1614
1055,zemich,50,41,9,1053,1012,1924
1056,svetu,50,41,9,1053,1012,1924
1057,vetrne,50,46,4,1053,867,6130
1058,mesic,50,33,17,1053,1310,666
1059,snadno,50,35,15,1053,1214,809
1060,dum,50,41,9,1053,1012,1924
1061,investice,50,41,9,1053,1012,1924
1062,klimatu,50,47,3,1053,842,7493
1063,pristi,50,33,17,1053,1310,666
1064,svetovou,50,39,11,1053,1075,1363
1065,otazkou,50,42,8,1053,984,2491
1066,lidska,50,35,15,1053,1214,809
1067,praha,49,34,15,1078,1261,809
1068,rano,49,33,16,1078,1310,727
1069,najit,49,25,24,1078,1810,361
1070,jakehosi,49,47,2,1078,842,10331
1071,oficialne,49,38,11,1078,1106,1363
1072,opilci,49,45,4,1078,898,6130
1073,aut,49,40,9,1078,1042,1924
1074,cetl,49,34,15,1078,1261,809
1075,prostor,49,45,4,1078,898,6130
1076,moderni,49,47,2,1078,842,10331
1077,hlavic,49,48,1,1078,813,20221
1078,zvlastni,49,26,23,1078,1729,391
1079,materialu,49,42,7,1078,984,3140
1080,spojenych,49,43,6,1078,952,4065
1081,krym,49,43,6,1078,952,4065
1082,existuji,49,34,15,1078,1261,809
1083,kazdopadne,49,34,15,1078,1261,809
1084,podporil,49,49,0,1078,786,49779
1085,polsku,49,41,8,1078,1012,2491
1086,postupne,49,44,5,1078,924,5101
1087,mnozi,49,25,24,1078,1810,361
1088,zdaleka,48,31,17,1106,1395,666
1089,elektrarnach,48,48,0,1106,813,49779
1090,vybuch,48,34,14,1106,1261,913
1091,dodal,48,42,6,1106,984,4065
1092,odbornici,48,37,11,1106,1137,1363
1093,rosatomu,48,46,2,1106,867,10331
1094,nechat,48,40,8,1106,1042,2491
1095,case,48,40,8,1106,1042,2491
1096,velmoci,48,45,3,1106,898,7493
1097,nestalo,48,36,12,1106,1173,1179
1098,sef,48,38,10,1106,1106,1614
1099,nejvic,48,28,20,1106,1582,501
1100,rozmisteni,48,40,8,1106,1042,2491
1101,lzi,48,32,16,1106,1352,727
1102,radiacni,48,43,5,1106,952,5101
1103,produkce,48,39,9,1106,1075,1924
1104,new,48,37,11,1106,1137,1363
1105,nekomu,48,34,14,1106,1261,913
1106,nesmysly,48,39,9,1106,1075,1924
1107,smyslu,48,33,15,1106,1310,809
1108,velikost,48,27,21,1106,1662,459
1109,rus,48,43,5,1106,952,5101
1110,cesi,48,36,12,1106,1173,1179
1111,cernobyl,48,43,5,1106,952,5101
1112,likvidace,48,35,13,1106,1214,1036
1113,pokani,48,32,16,1106,1352,727
1114,vyuziti,48,35,13,1106,1214,1036
1115,vysoke,48,36,12,1106,1173,1179
1116,nevidel,48,30,18,1106,1449,605
1117,hodi,48,26,22,1106,1729,424
1118,siti,48,36,12,1106,1173,1179
1119,zvysit,48,31,17,1106,1395,666
1120,podobe,48,41,7,1106,1012,3140
1121,zle,48,28,20,1106,1582,501
1122,iranu,48,41,7,1106,1012,3140
1123,nevysli,47,45,2,1135,898,10331
1124,dovolit,47,34,13,1135,1261,1036
1125,pozice,47,33,14,1135,1310,913
1126,radon,47,33,14,1135,1310,913
1127,znamo,47,35,12,1135,1214,1179
1128,ukrajinske,47,30,17,1135,1449,666
1129,vyroci,47,33,14,1135,1310,913
1130,cinnosti,47,39,8,1135,1075,2491
1131,pochopit,47,37,10,1135,1137,1614
1132,historie,47,43,4,1135,952,6130
1133,vedel,47,24,23,1135,1911,391
1134,dalsim,47,39,8,1135,1075,2491
1135,vlastnim,47,33,14,1135,1310,913
1136,radiu,47,47,0,1135,842,49779
1137,programu,47,41,6,1135,1012,4065
1138,nicemu,47,28,19,1135,1582,546
1139,proudu,47,38,9,1135,1106,1924
1140,potreby,47,36,11,1135,1173,1363
1141,takovym,47,34,13,1135,1261,1036
1142,pouziva,47,43,4,1135,952,6130
1143,zadnem,47,31,16,1135,1395,727
1144,zvyseni,47,34,13,1135,1261,1036
1145,slovy,47,28,19,1135,1582,546
1146,fungovat,46,32,14,1169,1352,913
1147,operaci,46,38,8,1169,1106,2491
1148,historicky,46,27,19,1169,1662,546
1149,financovani,46,37,9,1169,1137,1924
1150,lidskych,46,38,8,1169,1106,2491
1151,dodat,46,40,6,1169,1042,4065
1152,ambice,46,39,7,1169,1075,3140
1153,auto,46,36,10,1169,1173,1614
1154,pruplavu,46,46,0,1169,867,49779
1155,cnn,46,46,0,1169,867,49779
1156,neznamena,46,28,18,1169,1582,605
1157,westinghouse,46,44,2,1169,924,10331
1158,prostoru,46,37,9,1169,1137,1924
1159,archavt,46,46,0,1169,867,49779
1160,jednotky,46,35,11,1169,1214,1363
1161,stejnou,46,33,13,1169,1310,1036
1162,svetova,46,41,5,1169,1012,5101
1163,spolecneho,46,37,9,1169,1137,1924
1164,tun,46,43,3,1169,952,7493
1165,trh,46,39,7,1169,1075,3140
1166,doporucuji,46,39,7,1169,1075,3140
1167,rikat,46,26,20,1169,1729,501
1168,prime,46,27,19,1169,1662,546
1169,muzes,46,28,18,1169,1582,605
1170,zalezi,46,39,7,1169,1075,3140
1171,veskere,46,39,7,1169,1075,3140
1172,radioaktivniho,46,42,4,1169,984,6130
1173,drabove,46,35,11,1169,1214,1363
1174,desitek,46,40,6,1169,1042,4065
1175,akci,46,35,11,1169,1214,1363
1176,ptejme,46,46,0,1169,867,49779
1177,vychodni,46,39,7,1169,1075,3140
1178,emise,46,44,2,1169,924,10331
1179,pocitat,46,40,6,1169,1042,4065
1180,demokracii,46,26,20,1169,1729,501
1181,tanky,46,38,8,1169,1106,2491
1182,pozici,46,36,10,1169,1173,1614
1183,the,46,35,11,1169,1214,1363
1184,jednoznacne,46,43,3,1169,952,7493
1185,zruseni,46,30,16,1169,1449,727
1186,prani,46,23,23,1169,2024,391
1187,mld,46,42,4,1169,984,6130
1188,ceka,46,32,14,1169,1352,913
1189,prestoze,46,40,6,1169,1042,4065
1190,romove,46,45,1,1169,898,20221
1191,pomerne,45,29,16,1207,1505,727
1192,pricemz,45,34,11,1207,1261,1363
1193,neskakejme,45,45,0,1207,898,49779
1194,pondeli,45,33,12,1207,1310,1179
1195,nerozumi,45,39,6,1207,1075,4065
1196,kamuflovano,45,45,0,1207,898,49779
1197,ekonomiky,45,39,6,1207,1075,4065
1198,procesu,45,34,11,1207,1261,1363
1199,zemanovi,45,35,10,1207,1214,1614
1200,dostane,45,26,19,1207,1729,546
1201,jakych,45,36,9,1207,1173,1924
1202,byvaly,45,32,13,1207,1352,1036
1203,zvlaste,45,39,6,1207,1075,4065
1204,fajn,45,29,16,1207,1505,727
1205,obriho,45,45,0,1207,898,49779
1206,alexandrmitrofa,45,43,2,1207,952,10331
1207,cekat,45,26,19,1207,1729,546
1208,rizika,45,37,8,1207,1137,2491
1209,vystavba,45,44,1,1207,924,20221
1210,bizarnim,45,45,0,1207,898,49779
1211,kazdou,45,39,6,1207,1075,4065
1212,prezidentem,45,41,4,1207,1012,6130
1213,niceni,45,44,1,1207,924,20221
1214,cezu,45,41,4,1207,1012,6130
1215,pokracovat,45,41,4,1207,1012,6130
1216,rikaji,45,33,12,1207,1310,1179
1217,cisla,45,37,8,1207,1137,2491
1218,agresori,45,35,10,1207,1214,1614
1219,tvori,45,33,12,1207,1310,1179
1220,jejim,45,36,9,1207,1173,1924
1221,drazdi,45,45,0,1207,898,49779
1222,meste,44,30,14,1239,1449,913
1223,cine,44,37,7,1239,1137,3140
1224,pole,44,33,11,1239,1310,1363
1225,stacilo,44,28,16,1239,1582,727
1226,vysoce,44,39,5,1239,1075,5101
1227,noci,44,31,13,1239,1395,1036
1228,podivejte,44,36,8,1239,1173,2491
1229,tvrzeni,44,35,9,1239,1214,1924
1230,mluvil,44,37,7,1239,1137,3140
1231,navrh,44,25,19,1239,1810,546
1232,vondracek,44,29,15,1239,1505,809
1233,jizni,44,35,9,1239,1214,1924
1234,zato,44,28,16,1239,1582,727
1235,clanky,44,30,14,1239,1449,913
1236,trva,44,30,14,1239,1449,913
1237,neslo,44,25,19,1239,1810,546
1238,buh,44,34,10,1239,1261,1614
1239,scenar,44,40,4,1239,1042,6130
1240,rozumne,44,38,6,1239,1106,4065
1241,cechach,44,40,4,1239,1042,6130
1242,amerika,44,40,4,1239,1042,6130
1243,martin,44,42,2,1239,984,10331
1244,druhu,44,38,6,1239,1106,4065
1245,dohodu,44,37,7,1239,1137,3140
1246,verejneho,44,34,10,1239,1261,1614
1247,vedi,44,37,7,1239,1137,3140
1248,radost,44,24,20,1239,1911,501
1249,souvisi,44,26,18,1239,1729,605
1250,pouzije,44,42,2,1239,984,10331
1251,prispevek,44,34,10,1239,1261,1614
1252,delsi,44,40,4,1239,1042,6130
1253,niz,44,35,9,1239,1214,1924
1254,velkych,44,34,10,1239,1261,1614
1255,hlasu,43,22,21,1274,2135,459
1256,iraku,43,36,7,1274,1173,3140
1257,projekty,43,37,6,1274,1137,4065
1258,uhelnych,43,41,2,1274,1012,10331
1259,hledat,43,30,13,1274,1449,1036
1260,silou,43,38,5,1274,1106,5101
1261,nechal,43,32,11,1274,1352,1363
1262,pravidelne,43,28,15,1274,1582,809
1263,stava,43,30,13,1274,1449,1036
1264,doslova,43,29,14,1274,1505,913
1265,emisi,43,39,4,1274,1075,6130
1266,veku,43,26,17,1274,1729,666
1267,apod,43,38,5,1274,1106,5101
1268,afghanistanu,43,33,10,1274,1310,1614
1269,myslenky,43,25,18,1274,1810,605
1270,odkaz,43,33,10,1274,1310,1614
1271,ministra,43,35,8,1274,1214,2491
1272,ctvrtek,43,30,13,1274,1449,1036
1273,washingtonu,43,33,10,1274,1310,1614
1274,raketami,43,38,5,1274,1106,5101
1275,prachy,43,31,12,1274,1395,1179
1276,rozhodl,43,33,10,1274,1310,1614
1277,dvakrat,43,28,15,1274,1582,809
1278,duchu,43,18,25,1274,2661,332
1279,natolik,43,25,18,1274,1810,605
1280,skonci,43,31,12,1274,1395,1179
1281,zjevne,43,28,15,1274,1582,809
1282,medii,43,40,3,1274,1042,7493
1283,drahou,43,38,5,1274,1106,5101
1284,dotaci,43,37,6,1274,1137,4065
1285,pouzivaji,43,34,9,1274,1261,1924
1286,zivotu,43,33,10,1274,1310,1614
1287,siri,43,33,10,1274,1310,1614
1288,hraje,43,35,8,1274,1214,2491
1289,vedomi,43,33,10,1274,1310,1614
1290,soucasnosti,43,39,4,1274,1075,6130
1291,vyhrozuje,43,41,2,1274,1012,10331
1292,reakce,42,30,12,1318,1449,1179
1293,vlastnich,42,31,11,1318,1395,1363
1294,ucelem,42,33,9,1318,1310,1924
1295,tvrdit,42,31,11,1318,1395,1363
1296,hodnoty,42,36,6,1318,1173,4065
1297,prodlouzeni,42,40,2,1318,1042,10331
1298,chysta,42,27,15,1318,1662,809
1299,mistech,42,26,16,1318,1729,727
1300,mohu,42,30,12,1318,1449,1179
1301,systemy,42,42,0,1318,984,49779
1302,vyzkumu,42,37,5,1318,1137,5101
1303,potrebuji,42,34,8,1318,1261,2491
1304,vojenskou,42,34,8,1318,1261,2491
1305,vitezstvi,42,20,22,1318,2376,424
1306,politicka,42,36,6,1318,1173,4065
1307,civilizace,42,34,8,1318,1261,2491
1308,ministerstva,42,33,9,1318,1310,1924
1309,vzniku,42,39,3,1318,1075,7493
1310,pozornost,42,34,8,1318,1261,2491
1311,vztahy,42,36,6,1318,1173,4065
1312,pristup,42,39,3,1318,1075,7493
1313,plany,42,27,15,1318,1662,809
1314,oznamil,42,28,14,1318,1582,913
1315,lip,42,20,22,1318,2376,424
1316,krok,42,29,13,1318,1505,1036
1317,cil,42,39,3,1318,1075,7493
1318,metru,42,38,4,1318,1106,6130
1319,zalezitosti,42,28,14,1318,1582,913
1320,dochazi,42,33,9,1318,1310,1924
1321,prvnich,42,36,6,1318,1173,4065
1322,obcane,42,20,22,1318,2376,424
1323,gorbacov,42,30,12,1318,1449,1179
1324,vyzkum,42,35,7,1318,1214,3140
1325,telo,42,31,11,1318,1395,1363
1326,povazuje,42,38,4,1318,1106,6130
1327,chybi,42,21,21,1318,2248,459
1328,druheho,42,31,11,1318,1395,1363
1329,oba,42,26,16,1318,1729,727
1330,vysoky,42,31,11,1318,1395,1363
1331,nemecky,42,33,9,1318,1310,1924
1332,zeptat,42,29,13,1318,1505,1036
1333,tlak,42,31,11,1318,1395,1363
1334,jakym,42,25,17,1318,1810,666
1335,fb,42,41,1,1318,1012,20221
1336,mesicu,42,35,7,1318,1214,3140
1337,jinymi,42,28,14,1318,1582,913
1338,zrusit,42,31,11,1318,1395,1363
1339,dlouhe,42,27,15,1318,1662,809
1340,volebni,42,15,27,1318,3239,277
1341,vratit,42,30,12,1318,1449,1179
1342,sakra,42,31,11,1318,1395,1363
1343,nepritele,41,28,13,1361,1582,1036
1344,otevrene,41,37,4,1361,1137,6130
1345,strasne,41,22,19,1361,2135,546
1346,agrese,41,40,1,1361,1042,20221
1347,uvedomit,41,28,13,1361,1582,1036
1348,levnejsi,41,36,5,1361,1173,5101
1349,verim,41,30,11,1361,1449,1363
1350,agresor,41,31,10,1361,1395,1614
1351,obvykle,41,34,7,1361,1261,3140
1352,ekonomika,41,35,6,1361,1214,4065
1353,ochranu,41,35,6,1361,1214,4065
1354,napadeni,41,34,7,1361,1261,3140
1355,dvema,41,34,7,1361,1261,3140
1356,narody,41,34,7,1361,1261,3140
1357,rukou,41,31,10,1361,1395,1614
1358,spotreby,41,37,4,1361,1137,6130
1359,bezne,41,32,9,1361,1352,1924
1360,vypovezeni,41,26,15,1361,1729,809
1361,jasny,41,29,12,1361,1505,1179
1362,operace,41,31,10,1361,1395,1614
1363,zakony,41,25,16,1361,1810,727
1364,armadu,41,38,3,1361,1106,7493
1365,argument,41,29,12,1361,1505,1179
1366,muselo,41,33,8,1361,1310,2491
1367,kteremu,41,31,10,1361,1395,1614
1368,zni,41,35,6,1361,1214,4065
1369,skupina,41,36,5,1361,1173,5101
1370,min,41,34,7,1361,1261,3140
1371,rakousko,41,35,6,1361,1214,4065
1372,ok,41,27,14,1361,1662,913
1373,nastesti,41,31,10,1361,1395,1614
1374,migrantu,41,36,5,1361,1173,5101
1375,internetu,41,32,9,1361,1352,1924
1376,davat,41,29,12,1361,1505,1179
1377,zakona,41,19,22,1361,2518,424
1378,poradne,41,25,16,1361,1810,727
1379,britove,40,35,5,1400,1214,5101
1380,naivni,40,30,10,1400,1449,1614
1381,vysledky,40,30,10,1400,1449,1614
1382,vis,40,19,21,1400,2518,459
1383,de,40,30,10,1400,1449,1614
1384,omezeni,40,33,7,1400,1310,3140
1385,zime,40,34,6,1400,1261,4065
1386,predchozi,40,34,6,1400,1261,4065
1387,skody,40,28,12,1400,1582,1179
1388,spolupraci,40,37,3,1400,1137,7493
1389,evropskych,40,36,4,1400,1173,6130
1390,zisk,40,27,13,1400,1662,1036
1391,stary,40,22,18,1400,2135,605
1392,nahlasit,40,39,1,1400,1075,20221
1393,vzit,40,28,12,1400,1582,1179
1394,pouzitim,40,40,0,1400,1042,49779
1395,dohromady,40,32,8,1400,1352,2491
1396,prijit,40,33,7,1400,1310,3140
1397,narodu,40,36,4,1400,1173,6130
1398,objevi,40,31,9,1400,1395,1924
1399,cen,40,24,16,1400,1911,727
1400,rozhovoru,40,36,4,1400,1173,6130
1401,reci,40,29,11,1400,1505,1363
1402,ztraty,40,38,2,1400,1106,10331
1403,nasledujici,40,35,5,1400,1214,5101
1404,atomove,40,39,1,1400,1075,20221
1405,zaplati,40,37,3,1400,1137,7493
1406,top,40,18,22,1400,2661,424
1407,poruseni,40,36,4,1400,1173,6130
1408,teoreticky,40,35,5,1400,1214,5101
1409,tahle,40,27,13,1400,1662,1036
1410,odpovedi,40,30,10,1400,1449,1614
1411,nenavisti,40,16,24,1400,3019,361
1412,podarilo,40,29,11,1400,1505,1363
1413,maximalne,40,30,10,1400,1449,1614
1414,skvele,40,21,19,1400,2248,546
1415,zena,40,27,13,1400,1662,1036
1416,nasim,40,33,7,1400,1310,3140
1417,vychazi,40,35,5,1400,1214,5101
1418,oblast,40,32,8,1400,1352,2491
1419,ziji,40,37,3,1400,1137,7493
1420,diskuzi,40,32,8,1400,1352,2491
1421,revoluce,39,21,18,1450,2248,605
1422,fyziky,39,25,14,1450,1810,913
1423,vecne,39,32,7,1450,1352,3140
1424,obranu,39,31,8,1450,1395,2491
1425,letos,39,31,8,1450,1395,2491
1426,kilometru,39,36,3,1450,1173,7493
1427,prijdou,39,20,19,1450,2376,546
1428,dodavky,39,27,12,1450,1662,1179
1429,nesmyslne,39,26,13,1450,1729,1036
1430,snahu,39,38,1,1450,1106,20221
1431,funkci,39,23,16,1450,2024,727
1432,super,39,27,12,1450,1662,1179
1433,zitra,39,24,15,1450,1911,809
1434,mych,39,25,14,1450,1810,913
1435,republika,39,28,11,1450,1582,1363
1436,aktualni,39,34,5,1450,1261,5101
1437,existenci,39,34,5,1450,1261,5101
1438,el,39,32,7,1450,1352,3140
1439,zavislost,39,36,3,1450,1173,7493
1440,dojit,39,30,9,1450,1449,1924
1441,zmeni,39,26,13,1450,1729,1036
1442,nekolikrat,39,28,11,1450,1582,1363
1443,konvencni,39,35,4,1450,1214,6130
1444,zajistit,39,36,3,1450,1173,7493
1445,nest,39,37,2,1450,1137,10331
1446,elektromobilu,39,37,2,1450,1137,10331
1447,typ,39,34,5,1450,1261,5101
1448,drzet,39,23,16,1450,2024,727
1449,chemicke,39,34,5,1450,1261,5101
1450,zeny,39,24,15,1450,1911,809
1451,jdou,39,29,10,1450,1505,1614
1452,expert,39,30,9,1450,1449,1924
1453,rozum,39,27,12,1450,1662,1179
1454,trvat,39,28,11,1450,1582,1363
1455,vychod,39,35,4,1450,1214,6130
1456,dohoda,39,32,7,1450,1352,3140
1457,strach,39,30,9,1450,1449,1924
1458,nezavislost,39,33,6,1450,1310,4065
1459,americkou,39,30,9,1450,1449,1924
1460,ruku,39,27,12,1450,1662,1179
1461,ropu,39,35,4,1450,1214,6130
1462,vyplyva,39,33,6,1450,1310,4065
1463,zivoty,39,22,17,1450,2135,666
1464,soud,39,28,11,1450,1582,1363
1465,specialni,39,30,9,1450,1449,1924
1466,svemu,39,31,8,1450,1395,2491
1467,diskuze,39,27,12,1450,1662,1179
1468,skrze,39,36,3,1450,1173,7493
1469,vojenska,39,39,0,1450,1075,49779
1470,silu,39,31,8,1450,1395,2491
1471,zapadnich,39,29,10,1450,1505,1614
1472,nejakym,39,33,6,1450,1310,4065
1473,udrzet,39,28,11,1450,1582,1363
1474,drahe,39,39,0,1450,1075,49779
1475,zname,39,28,11,1450,1582,1363
1476,ekologicke,39,36,3,1450,1173,7493
1477,kanal,39,35,4,1450,1214,6130
1478,politickych,39,26,13,1450,1729,1036
1479,zony,38,22,16,1502,2135,727
1480,potrebujeme,38,31,7,1502,1395,3140
1481,dodavat,38,34,4,1502,1261,6130
1482,ucast,38,20,18,1502,2376,605
1483,modelu,38,30,8,1502,1449,2491
1484,precist,38,29,9,1502,1505,1924
1485,hospodarstvi,38,23,15,1502,2024,809
1486,poradce,38,28,10,1502,1582,1614
1487,studene,38,33,5,1502,1310,5101
1488,velkem,38,29,9,1502,1505,1924
1489,britanii,38,31,7,1502,1395,3140
1490,vysledku,38,29,9,1502,1505,1924
1491,varovani,38,31,7,1502,1395,3140
1492,pocatku,38,27,11,1502,1662,1363
1493,provest,38,36,2,1502,1173,10331
1494,cizi,38,27,11,1502,1662,1363
1495,vysvetleni,38,28,10,1502,1582,1614
1496,musela,38,31,7,1502,1395,3140
1497,tanku,38,26,12,1502,1729,1179
1498,odmitl,38,34,4,1502,1261,6130
1499,opakovane,38,35,3,1502,1214,7493
1500,republiku,38,27,11,1502,1662,1363
1501,mucednici,38,28,10,1502,1582,1614
1502,model,38,25,13,1502,1810,1036
1503,mw,38,33,5,1502,1310,5101
1504,podpora,38,30,8,1502,1449,2491
1505,radsi,38,20,18,1502,2376,605
1506,krasne,38,23,15,1502,2024,809
1507,minuly,38,20,18,1502,2376,605
1508,mnohe,38,25,13,1502,1810,1036
1509,zakonu,38,28,10,1502,1582,1614
1510,tsunami,38,30,8,1502,1449,2491
1511,putinem,38,28,10,1502,1582,1614
1512,ukrajinska,38,22,16,1502,2135,727
1513,pravidla,38,19,19,1502,2518,546
1514,levne,38,28,10,1502,1582,1614
1515,tezby,38,38,0,1502,1106,49779
1516,oficialni,38,33,5,1502,1310,5101
1517,centralni,38,23,15,1502,2024,809
1518,patrne,38,19,19,1502,2518,546
1519,technicky,38,35,3,1502,1214,7493
1520,probiha,38,30,8,1502,1449,2491
1521,tenkrat,38,24,14,1502,1911,913
1522,vidite,38,25,13,1502,1810,1036
1523,umele,38,23,15,1502,2024,809
1524,klidu,37,26,11,1554,1729,1363
1525,uvidime,37,29,8,1554,1505,2491
1526,tomuto,37,28,9,1554,1582,1924
1527,cinou,37,28,9,1554,1582,1924
1528,pokus,37,20,17,1554,2376,666
1529,latky,37,25,12,1554,1810,1179
1530,pripravuji,37,30,7,1554,1449,3140
1531,tomhle,37,23,14,1554,2024,913
1532,kus,37,25,12,1554,1810,1179
1533,dani,37,21,16,1554,2248,727
1534,socialni,37,23,14,1554,2024,913
1535,bohatstvi,37,28,9,1554,1582,1924
1536,vyvoji,37,37,0,1554,1137,49779
1537,nekam,37,24,13,1554,1911,1036
1538,opatreni,37,34,3,1554,1261,7493
1539,dulezity,37,21,16,1554,2248,727
1540,soucasna,37,24,13,1554,1911,1036
1541,natoz,37,25,12,1554,1810,1179
1542,resp,37,31,6,1554,1395,4065
1543,neuveritelne,37,26,11,1554,1729,1363
1544,paks,37,36,1,1554,1173,20221
1545,plus,37,25,12,1554,1810,1179
1546,vidime,37,26,11,1554,1729,1363
1547,fve,37,28,9,1554,1582,1924
1548,predsedkyne,37,35,2,1554,1214,10331
1549,zdravi,37,31,6,1554,1395,4065
1550,okamziku,37,29,8,1554,1505,2491
1551,pripomina,37,25,12,1554,1810,1179
1552,vaseho,37,22,15,1554,2135,809
1553,bruselu,37,22,15,1554,2135,809
1554,sankci,37,22,15,1554,2135,809
1555,rozvoj,37,34,3,1554,1261,7493
1556,nedostatek,37,32,5,1554,1352,5101
1557,nejsme,37,34,3,1554,1261,7493
1558,absolutne,37,28,9,1554,1582,1924
1559,baterie,37,35,2,1554,1214,10331
1560,vzdelani,37,24,13,1554,1911,1036
1561,zkuste,37,26,11,1554,1729,1363
1562,cesty,37,34,3,1554,1261,7493
1563,chtela,37,25,12,1554,1810,1179
1564,raketovy,37,31,6,1554,1395,4065
1565,rychlosti,37,32,5,1554,1352,5101
1566,plny,37,20,17,1554,2376,666
1567,smrt,37,29,8,1554,1505,2491
1568,knihy,37,17,20,1554,2828,501
1569,pamatuji,37,24,13,1554,1911,1036
1570,ucit,37,19,18,1554,2518,605
1571,zbrojni,37,30,7,1554,1449,3140
1572,konkretni,37,24,13,1554,1911,1036
1573,pracuje,37,30,7,1554,1449,3140
1574,vzajemne,37,35,2,1554,1214,10331
1575,televizi,37,25,12,1554,1810,1179
1576,politik,37,24,13,1554,1911,1036
1577,chovat,37,17,20,1554,2828,501
1578,fuze,37,36,1,1554,1173,20221
1579,temeline,37,37,0,1554,1137,49779
1580,informacni,37,25,12,1554,1810,1179
1581,odbornik,37,30,7,1554,1449,3140
1582,nichz,37,24,13,1554,1911,1036
1583,snemovny,36,20,16,1612,2376,727
1584,slyset,36,28,8,1612,1582,2491
1585,cert,36,32,4,1612,1352,6130
1586,jisty,36,23,13,1612,2024,1036
1587,vmesovani,36,21,15,1612,2248,809
1588,armade,36,30,6,1612,1449,4065
1589,skole,36,23,13,1612,2024,1036
1590,pouzijeme,36,36,0,1612,1173,49779
1591,vs,36,25,11,1612,1810,1363
1592,masivni,36,30,6,1612,1449,4065
1593,politickou,36,28,8,1612,1582,2491
1594,castecne,36,28,8,1612,1582,2491
1595,puvodne,36,28,8,1612,1582,2491
1596,rekneme,36,24,12,1612,1911,1179
1597,sledovat,36,26,10,1612,1729,1614
1598,limity,36,34,2,1612,1261,10331
1599,pevne,36,28,8,1612,1582,2491
1600,informoval,36,21,15,1612,2248,809
1601,pripada,36,28,8,1612,1582,2491
1602,ocividne,36,24,12,1612,1911,1179
1603,ohrozeni,36,35,1,1612,1214,20221
1604,zastupce,36,21,15,1612,2248,809
1605,nadeji,36,26,10,1612,1729,1614
1606,momentalne,36,31,5,1612,1395,5101
1607,mocnosti,36,32,4,1612,1352,6130
1608,hlavici,36,33,3,1612,1310,7493
1609,bomba,36,26,10,1612,1729,1614
1610,veri,36,29,7,1612,1505,3140
1611,katastrofy,36,31,5,1612,1395,5101
1612,vladu,36,33,3,1612,1310,7493
1613,agresivni,36,31,5,1612,1395,5101
1614,ziskani,36,32,4,1612,1352,6130
1615,prozatim,36,32,4,1612,1352,6130
1616,dam,36,14,22,1612,3490,424
1617,vyznam,36,25,11,1612,1810,1363
1618,povedlo,36,32,4,1612,1352,6130
1619,ceskou,36,28,8,1612,1582,2491
1620,mozneho,36,24,12,1612,1911,1179
1621,pozitivni,36,28,8,1612,1582,2491
1622,schopnosti,36,28,8,1612,1582,2491
1623,vybaveni,36,26,10,1612,1729,1614
1624,preventivni,36,35,1,1612,1214,20221
1625,prostredku,36,28,8,1612,1582,2491
1626,chovani,36,22,14,1612,2135,913
1627,pisete,36,14,22,1612,3490,424
1628,jmenem,36,24,12,1612,1911,1179
1629,jednoduche,36,27,9,1612,1662,1924
1630,rustu,36,20,16,1612,2376,727
1631,lidmi,36,25,11,1612,1810,1363
1632,dopravni,36,23,13,1612,2024,1036
1633,praxi,36,34,2,1612,1261,10331
1634,ponorky,36,33,3,1612,1310,7493
1635,prectete,36,29,7,1612,1505,3140
1636,drazsi,36,34,2,1612,1261,10331
1637,putinova,36,31,5,1612,1395,5101
1638,ukrajinsky,36,21,15,1612,2248,809
1639,material,36,31,5,1612,1395,5101
1640,podminkach,35,28,7,1670,1582,3140
1641,dosahnout,35,31,4,1670,1395,6130
1642,myslis,35,22,13,1670,2135,1036
1643,obcany,35,25,10,1670,1810,1614
1644,nemluve,35,31,4,1670,1395,6130
1645,trpi,35,20,15,1670,2376,809
1646,ucasti,35,15,20,1670,3239,501
1647,napsat,35,22,13,1670,2135,1036
1648,nemeni,35,21,14,1670,2248,913
1649,volicu,35,9,26,1670,5608,302
1650,kontextu,35,26,9,1670,1729,1924
1651,cerne,35,20,15,1670,2376,809
1652,americkym,35,28,7,1670,1582,3140
1653,ptat,35,23,12,1670,2024,1179
1654,tela,35,24,11,1670,1911,1363
1655,existence,35,34,1,1670,1261,20221
1656,schopna,35,28,7,1670,1582,3140
1657,donbasu,35,19,16,1670,2518,727
1658,fyzik,35,13,22,1670,3784,424
1659,poradu,35,23,12,1670,2024,1179
1660,nepritel,35,28,7,1670,1582,3140
1661,cssd,35,18,17,1670,2661,666
1662,katastrofa,35,33,2,1670,1310,10331
1663,slouzi,35,27,8,1670,1662,2491
1664,domaci,35,27,8,1670,1662,2491
1665,vzduchu,35,26,9,1670,1729,1924
1666,stare,35,27,8,1670,1662,2491
1667,potrebu,35,24,11,1670,1911,1363
1668,ukazalo,35,31,4,1670,1395,6130
1669,kterymi,35,16,19,1670,3019,546
1670,zacatek,35,27,8,1670,1662,2491
1671,vidi,35,33,2,1670,1310,10331
1672,novicok,35,20,15,1670,2376,809
1673,zmene,35,29,6,1670,1505,4065
1674,miri,35,31,4,1670,1395,6130
1675,kroky,35,32,3,1670,1352,7493
1676,tridy,35,26,9,1670,1729,1924
1677,furt,35,24,11,1670,1911,1363
1678,predseda,35,16,19,1670,3019,546
1679,rise,35,23,12,1670,2024,1179
1680,zachovani,35,28,7,1670,1582,3140
1681,polsko,35,29,6,1670,1505,4065
1682,spousta,35,26,9,1670,1729,1924
1683,polska,35,27,8,1670,1662,2491
1684,uranu,35,31,4,1670,1395,6130
1685,vyznamne,35,29,6,1670,1505,4065
1686,napeti,35,29,6,1670,1505,4065
1687,vodou,35,24,11,1670,1911,1363
1688,rodiny,35,19,16,1670,2518,727
1689,bombu,35,32,3,1670,1352,7493
1690,peti,35,28,7,1670,1582,3140
1691,kldr,35,33,2,1670,1310,10331
1692,prichazi,35,16,19,1670,3019,546
1693,radioaktivity,35,27,8,1670,1662,2491
1694,milos,35,28,7,1670,1582,3140
1695,potencial,35,30,5,1670,1449,5101
1696,novym,35,21,14,1670,2248,913
1697,chemickych,35,27,8,1670,1662,2491
1698,obyvatelstvo,35,23,12,1670,2024,1179
1699,casem,35,32,3,1670,1352,7493
1700,prednost,34,30,4,1729,1449,6130
1701,financi,34,27,7,1729,1662,3140
1702,bojuje,34,27,7,1729,1662,3140
1703,rozporu,34,29,5,1729,1505,5101
1704,volici,34,7,27,1729,7246,277
1705,zkratka,34,25,9,1729,1810,1924
1706,rozhovor,34,29,5,1729,1505,5101
1707,vybral,34,31,3,1729,1395,7493
1708,odporu,34,33,1,1729,1310,20221
1709,neceho,34,22,12,1729,2135,1179
1710,tematu,34,25,9,1729,1810,1924
1711,narazil,34,28,6,1729,1582,4065
1712,neverim,34,23,11,1729,2024,1363
1713,meni,34,29,5,1729,1505,5101
1714,potrebovat,34,21,13,1729,2248,1036
1715,abyste,34,21,13,1729,2248,1036
1716,uspesne,34,28,6,1729,1582,4065
1717,dostavbe,34,33,1,1729,1310,20221
1718,pouzivat,34,28,6,1729,1582,4065
1719,dostavba,34,34,0,1729,1261,49779
1720,vzali,34,16,18,1729,3019,605
1721,zpatky,34,22,12,1729,2135,1179
1722,aktualne,34,29,5,1729,1505,5101
1723,bavime,34,29,5,1729,1505,5101
1724,fyziku,34,13,21,1729,3784,459
1725,normalne,34,26,8,1729,1729,2491
1726,nerekl,34,23,11,1729,2024,1363
1727,porusuje,34,29,5,1729,1505,5101
1728,nesmime,34,31,3,1729,1395,7493
1729,dostatek,34,19,15,1729,2518,809
1730,zapadem,34,19,15,1729,2518,809
1731,znamy,34,23,11,1729,2024,1363
1732,prodlouzit,34,33,1,1729,1310,20221
1733,pocita,34,29,5,1729,1505,5101
1734,gw,34,31,3,1729,1395,7493
1735,ridi,34,28,6,1729,1582,4065
1736,velikosti,34,30,4,1729,1449,6130
1737,lode,34,32,2,1729,1352,10331
1738,nevedel,34,20,14,1729,2376,913
1739,nehrozi,34,27,7,1729,1662,3140
1740,general,34,26,8,1729,1729,2491
1741,delo,34,22,12,1729,2135,1179
1742,hodnot,34,32,2,1729,1352,10331
1743,touto,34,28,6,1729,1582,4065
1744,ostatnich,34,30,4,1729,1449,6130
1745,vojenskych,34,32,2,1729,1352,10331
1746,novem,34,24,10,1729,1911,1614
1747,ponorek,34,31,3,1729,1395,7493
1748,indie,34,32,2,1729,1352,10331
1749,chodi,34,24,10,1729,1911,1614
1750,realita,34,27,7,1729,1662,3140
1751,letadel,34,24,10,1729,1911,1614
1752,medaili,34,34,0,1729,1261,49779
1753,kg,34,24,10,1729,1911,1614
1754,odpovednost,34,19,15,1729,2518,809
1755,firma,34,27,7,1729,1662,3140
1756,firem,34,32,2,1729,1352,10331
1757,diskusi,33,24,9,1791,1911,1924
1758,povazuji,33,21,12,1791,2248,1179
1759,kaliningradu,33,28,5,1791,1582,5101
1760,dany,33,17,16,1791,2828,727
1761,pujdou,33,30,3,1791,1449,7493
1762,krizi,33,22,11,1791,2135,1363
1763,diskuse,33,23,10,1791,2024,1614
1764,obyvatelstva,33,28,5,1791,1582,5101
1765,rikal,33,24,9,1791,1911,1924
1766,mladi,33,15,18,1791,3239,605
1767,saudske,33,20,13,1791,2376,1036
1768,hranicich,33,24,9,1791,1911,1924
1769,nasili,33,17,16,1791,2828,727
1770,nachazi,33,24,9,1791,1911,1924
1771,obnovitelnych,33,28,5,1791,1582,5101
1772,staly,33,32,1,1791,1352,20221
1773,neho,33,22,11,1791,2135,1363
1774,parlament,33,12,21,1791,4133,459
1775,novinare,33,15,18,1791,3239,605
1776,cinnost,33,28,5,1791,1582,5101
1777,nejmene,33,31,2,1791,1395,10331
1778,nehlede,33,27,6,1791,1662,4065
1779,absolutni,33,23,10,1791,2024,1614
1780,stali,33,13,20,1791,3784,501
1781,pruser,33,22,11,1791,2135,1363
1782,vlivu,33,28,5,1791,1582,5101
1783,nemecti,33,31,2,1791,1395,10331
1784,schopne,33,31,2,1791,1395,10331
1785,vytvari,33,28,5,1791,1582,5101
1786,propaganda,33,21,12,1791,2248,1179
1787,stabilni,33,31,2,1791,1395,10331
1788,americanum,33,27,6,1791,1662,4065
1789,jednoduse,33,26,7,1791,1729,3140
1790,tunel,33,30,3,1791,1449,7493
1791,duse,33,17,16,1791,2828,727
1792,kapitalismu,33,19,14,1791,2518,913
1793,vysoka,33,27,6,1791,1662,4065
1794,raje,33,33,0,1791,1310,49779
1795,elektricke,33,32,1,1791,1352,20221
1796,hinkley,33,32,1,1791,1352,20221
1797,cislo,33,24,9,1791,1911,1924
1798,vzdalenosti,33,26,7,1791,1729,3140
1799,jaderni,33,21,12,1791,2248,1179
1800,souhlas,33,24,9,1791,1911,1924
1801,pripravuje,33,29,4,1791,1505,6130
1802,technicke,33,30,3,1791,1449,7493
1803,zem,33,22,11,1791,2135,1363
1804,oznacil,33,17,16,1791,2828,727
1805,zakazky,33,29,4,1791,1505,6130
1806,nemohu,33,22,11,1791,2135,1363
1807,libi,33,18,15,1791,2661,809
1808,kyjev,33,23,10,1791,2024,1614
1809,majetku,33,26,7,1791,1729,3140
1810,jedineho,33,28,5,1791,1582,5101
1811,tydnu,33,20,13,1791,2376,1036
1812,verzi,33,30,3,1791,1449,7493
1813,tvrda,33,23,10,1791,2024,1614
1814,policie,33,25,8,1791,1810,2491
1815,nevite,33,19,14,1791,2518,913
1816,pobalti,33,26,7,1791,1729,3140
1817,patek,33,22,11,1791,2135,1363
1818,hrozbou,33,29,4,1791,1505,6130
1819,pocasi,33,27,6,1791,1662,4065
1820,sila,33,29,4,1791,1505,6130
1821,evidentne,33,19,14,1791,2518,913
1822,ochrany,33,30,3,1791,1449,7493
1823,hrozba,33,29,4,1791,1505,6130
1824,prahu,33,17,16,1791,2828,727
1825,radioaktivnim,32,26,6,1856,1729,4065
1826,roste,32,21,11,1856,2248,1363
1827,nejhorsi,32,21,11,1856,2248,1363
1828,washington,32,23,9,1856,2024,1924
1829,dukazy,32,23,9,1856,2024,1924
1830,radioaktivita,32,27,5,1856,1662,5101
1831,zil,32,18,14,1856,2661,913
1832,zdrojem,32,29,3,1856,1505,7493
1833,britske,32,26,6,1856,1729,4065
1834,hranicim,32,24,8,1856,1911,2491
1835,vazaly,32,32,0,1856,1352,49779
1836,mysleni,32,26,6,1856,1729,4065
1837,podniku,32,25,7,1856,1810,3140
1838,dokument,32,25,7,1856,1810,3140
1839,statem,32,26,6,1856,1729,4065
1840,povoleni,32,28,4,1856,1582,6130
1841,post,32,28,4,1856,1582,6130
1842,arabie,32,20,12,1856,2376,1179
1843,zajimalo,32,29,3,1856,1505,7493
1844,pavel,32,22,10,1856,2135,1614
1845,nechtel,32,14,18,1856,3490,605
1846,muzu,32,22,10,1856,2135,1614
1847,nejblizsi,32,23,9,1856,2024,1924
1848,parametry,32,20,12,1856,2376,1179
1849,dalsimi,32,24,8,1856,1911,2491
1850,budoucnu,32,29,3,1856,1505,7493
1851,holt,32,24,8,1856,1911,2491
1852,prisla,32,23,9,1856,2024,1924
1853,zadost,32,24,8,1856,1911,2491
1854,nejdulezitejsi,32,28,4,1856,1582,6130
1855,tradicni,32,17,15,1856,2828,809
1856,centra,32,23,9,1856,2024,1924
1857,vysvetlovat,32,18,14,1856,2661,913
1858,nuklearnich,32,30,2,1856,1449,10331
1859,delali,32,20,12,1856,2376,1179
1860,velkym,32,24,8,1856,1911,2491
1861,oteplovani,32,30,2,1856,1449,10331
1862,nemelo,32,28,4,1856,1582,6130
1863,stejneho,32,23,9,1856,2024,1924
1864,vsim,32,22,10,1856,2135,1614
1865,znacne,32,30,2,1856,1449,10331
1866,mereni,32,29,3,1856,1505,7493
1867,ceskeho,32,23,9,1856,2024,1924
1868,hitler,32,24,8,1856,1911,2491
1869,menit,32,18,14,1856,2661,913
1870,jakmile,32,24,8,1856,1911,2491
1871,kvalita,32,25,7,1856,1810,3140
1872,prospech,32,28,4,1856,1582,6130
1873,premierem,32,28,4,1856,1582,6130
1874,chybu,32,20,12,1856,2376,1179
1875,vladni,32,23,9,1856,2024,1924
1876,aktivne,32,25,7,1856,1810,3140
1877,donalda,32,29,3,1856,1505,7493
1878,skoncime,32,22,10,1856,2135,1614
1879,dostavby,32,30,2,1856,1449,10331
1880,pokracuje,32,24,8,1856,1911,2491
1881,stredu,32,27,5,1856,1662,5101
1882,sovetsky,32,23,9,1856,2024,1924
1883,stacit,32,29,3,1856,1505,7493
1884,atomovych,32,23,9,1856,2024,1924
1885,kyjeve,32,16,16,1856,3019,727
1886,httppictwittercomzmtaxhis,31,31,0,1928,1395,49779
1887,dostanou,31,23,8,1928,2024,2491
1888,dopredu,31,28,3,1928,1582,7493
1889,teorie,31,26,5,1928,1729,5101
1890,lidskou,31,17,14,1928,2828,913
1891,zakazat,31,31,0,1928,1395,49779
1892,fakta,31,25,6,1928,1810,4065
1893,porusovani,31,20,11,1928,2376,1363
1894,realny,31,20,11,1928,2376,1363
1895,uderem,31,24,7,1928,1911,3140
1896,agentu,31,27,4,1928,1662,6130
1897,izraeli,31,23,8,1928,2024,2491
1898,principu,31,26,5,1928,1729,5101
1899,cene,31,29,2,1928,1505,10331
1900,cini,31,28,3,1928,1582,7493
1901,uvnitr,31,26,5,1928,1729,5101
1902,predpokladam,31,28,3,1928,1582,7493
1903,ceste,31,24,7,1928,1911,3140
1904,kecy,31,19,12,1928,2518,1179
1905,termin,31,17,14,1928,2828,913
1906,vladimira,31,25,6,1928,1810,4065
1907,nohy,31,19,12,1928,2518,1179
1908,obri,31,24,7,1928,1911,3140
1909,bordel,31,20,11,1928,2376,1363
1910,zustava,31,18,13,1928,2661,1036
1911,clenove,31,17,14,1928,2828,913
1912,odpovedet,31,23,8,1928,2024,2491
1913,vetru,31,26,5,1928,1729,5101
1914,uprostred,31,16,15,1928,3019,809
1915,minimalni,31,21,10,1928,2248,1614
1916,budovani,31,28,3,1928,1582,7493
1917,studii,31,21,10,1928,2248,1614
1918,bat,31,18,13,1928,2661,1036
1919,nemozne,31,19,12,1928,2518,1179
1920,jmeno,31,21,10,1928,2248,1614
1921,stejni,31,11,20,1928,4527,501
1922,kontrolou,31,17,14,1928,2828,913
1923,svetlo,31,14,17,1928,3490,666
1924,ekonomice,31,24,7,1928,1911,3140
1925,mem,31,15,16,1928,3239,727
1926,funkce,31,16,15,1928,3019,809
1927,bomb,31,23,8,1928,2024,2491
1928,dolu,31,20,11,1928,2376,1363
1929,protesty,31,28,3,1928,1582,7493
1930,pohybuje,31,25,6,1928,1810,4065
1931,priroda,31,28,3,1928,1582,7493
1932,agresi,31,30,1,1928,1449,20221
1933,vstupu,31,21,10,1928,2248,1614
1934,srdce,31,20,11,1928,2376,1363
1935,slysel,31,18,13,1928,2661,1036
1936,babisovi,31,19,12,1928,2518,1179
1937,severnich,31,29,2,1928,1505,10331
1938,obnovit,31,30,1,1928,1449,20221
1939,komentare,31,21,10,1928,2248,1614
1940,vytvorit,31,21,10,1928,2248,1614
1941,radonu,31,30,1,1928,1449,20221
1942,priblizne,31,30,1,1928,1449,20221
1943,zemanem,31,25,6,1928,1810,4065
1944,odvetneho,31,25,6,1928,1810,4065
1945,nemusim,31,20,11,1928,2376,1363
1946,cilu,31,23,8,1928,2024,2491
1947,lid,31,24,7,1928,1911,3140
1948,velkeho,31,25,6,1928,1810,4065
1949,sluzeb,31,24,7,1928,1911,3140
1950,popsal,31,16,15,1928,3019,809
1951,strel,31,28,3,1928,1582,7493
1952,stranou,31,18,13,1928,2661,1036
1953,nedaleko,31,22,9,1928,2135,1924
1954,dari,31,16,15,1928,3019,809
1955,koupit,31,26,5,1928,1729,5101
1956,munici,31,24,7,1928,1911,3140
1957,spojenymi,31,20,11,1928,2376,1363
1958,podniky,31,20,11,1928,2376,1363
1959,zlikvidovat,31,28,3,1928,1582,7493
1960,lod,31,22,9,1928,2135,1924
1961,tvrdil,31,21,10,1928,2248,1614
1962,rokem,31,25,6,1928,1810,4065
1963,odzbrojeni,31,28,3,1928,1582,7493
1964,efektivni,31,30,1,1928,1449,20221
1965,zakaz,31,27,4,1928,1662,6130
1966,vsemu,31,19,12,1928,2518,1179
1967,predstavitele,31,26,5,1928,1729,5101
1968,znalosti,31,24,7,1928,1911,3140
1969,rozsireni,31,26,5,1928,1729,5101
1970,kazdemu,30,28,2,2008,1582,10331
1971,ameriky,30,27,3,2008,1662,7493
1972,zajima,30,27,3,2008,1662,7493
1973,cech,30,24,6,2008,1911,4065
1974,max,30,25,5,2008,1810,5101
1975,dala,30,13,17,2008,3784,666
1976,prechod,30,21,9,2008,2248,1924
1977,stavajici,30,27,3,2008,1662,7493
1978,komunisti,30,12,18,2008,4133,605
1979,byvaleho,30,27,3,2008,1662,7493
1980,zjistit,30,26,4,2008,1729,6130
1981,energetickou,30,25,5,2008,1810,5101
1982,ac,30,24,6,2008,1911,4065
1983,komentar,30,21,9,2008,2248,1924
1984,pripraveni,30,28,2,2008,1582,10331
1985,vyjadrovat,30,15,15,2008,3239,809
1986,proboha,30,17,13,2008,2828,1036
1987,hnuti,30,17,13,2008,2828,1036
1988,prezit,30,25,5,2008,1810,5101
1989,starych,30,18,12,2008,2661,1179
1990,starsi,30,15,15,2008,3239,809
1991,proud,30,20,10,2008,2376,1614
1992,argumenty,30,26,4,2008,1729,6130
1993,spatny,30,24,6,2008,1911,4065
1994,jedinou,30,23,7,2008,2024,3140
1995,ocich,30,15,15,2008,3239,809
1996,ukrajinci,30,22,8,2008,2135,2491
1997,mesto,30,22,8,2008,2135,2491
1998,munice,30,18,12,2008,2661,1179
1999,komuniste,30,16,14,2008,3019,913
2000,textu,30,27,3,2008,1662,7493
2001,zvlast,30,25,5,2008,1810,5101
2002,ovlada,30,29,1,2008,1505,20221
2003,soudruh,30,12,18,2008,4133,605
2004,spotreba,30,25,5,2008,1810,5101
2005,blizi,30,25,5,2008,1810,5101
2006,takovem,30,26,4,2008,1729,6130
2007,raketove,30,25,5,2008,1810,5101
2008,reknu,30,7,23,2008,7246,391
2009,socialismus,30,18,12,2008,2661,1179
2010,krve,30,20,10,2008,2376,1614
2011,uplny,30,12,18,2008,4133,605
2012,vyrobou,30,20,10,2008,2376,1614
2013,trest,30,17,13,2008,2828,1036
2014,niceho,30,20,10,2008,2376,1614
2015,jakekoliv,30,25,5,2008,1810,5101
2016,konference,30,16,14,2008,3019,913
2017,ukazat,30,25,5,2008,1810,5101
2018,americe,30,28,2,2008,1582,10331
2019,pozor,30,22,8,2008,2135,2491
2020,marie,30,23,7,2008,2024,3140
2021,kdekoliv,30,20,10,2008,2376,1614
2022,nepatri,30,23,7,2008,2024,3140
2023,nepratele,30,28,2,2008,1582,10331
2024,pokrok,30,25,5,2008,1810,5101
2025,svedomi,30,18,12,2008,2661,1179
2026,plochou,30,25,5,2008,1810,5101
2027,silnice,30,23,7,2008,2024,3140
2028,klid,30,24,6,2008,1911,4065
2029,vyrobni,30,24,6,2008,1911,4065
2030,souladu,30,28,2,2008,1582,10331
2031,americani,30,24,6,2008,1911,4065
2032,napsala,30,15,15,2008,3239,809
2033,nemas,30,20,10,2008,2376,1614
2034,vetsine,30,17,13,2008,2828,1036
2035,cssr,30,24,6,2008,1911,4065
2036,kdybych,30,13,17,2008,3784,666
2037,dite,30,16,14,2008,3019,913
2038,cekal,30,15,15,2008,3239,809
2039,naroda,30,19,11,2008,2518,1363
2040,smeru,30,26,4,2008,1729,6130
2041,nemeckych,30,21,9,2008,2248,1924
2042,jidla,30,15,15,2008,3239,809
2043,cile,30,24,6,2008,1911,4065
2044,znamenalo,30,29,1,2008,1505,20221
2045,bile,30,18,12,2008,2661,1179
2046,vzal,29,20,9,2093,2376,1924
2047,tepelne,29,27,2,2093,1662,10331
2048,objevil,29,22,7,2093,2135,3140
2049,doposud,29,23,6,2093,2024,4065
2050,hrat,29,19,10,2093,2518,1614
2051,jednotlivych,29,23,6,2093,2024,4065
2052,spojit,29,27,2,2093,1662,10331
2053,vzoru,29,27,2,2093,1662,10331
2054,odvetu,29,27,2,2093,1662,10331
2055,hele,29,14,15,2093,3490,809
2056,cestiny,29,25,4,2093,1810,6130
2057,zelene,29,26,3,2093,1729,7493
2058,via,29,28,1,2093,1582,20221
2059,jakubjanda,29,29,0,2093,1505,49779
2060,unie,29,23,6,2093,2024,4065
2061,policii,29,19,10,2093,2518,1614
2062,rozsirovat,29,29,0,2093,1505,49779
2063,totalni,29,18,11,2093,2661,1363
2064,mluvim,29,20,9,2093,2376,1924
2065,jinem,29,20,9,2093,2376,1924
2066,vysetrovani,29,21,8,2093,2248,2491
2067,zuby,29,15,14,2093,3239,913
2068,fuzi,29,28,1,2093,1582,20221
2069,hodiny,29,25,4,2093,1810,6130
2070,zemrel,29,25,4,2093,1810,6130
2071,kuzi,29,13,16,2093,3784,727
2072,prelozeno,29,29,0,2093,1505,49779
2073,zamerne,29,25,4,2093,1810,6130
2074,rekni,29,20,9,2093,2376,1924
2075,nemeckem,29,24,5,2093,1911,5101
2076,opakuje,29,21,8,2093,2248,2491
2077,zacaly,29,19,10,2093,2518,1614
2078,tlaku,29,21,8,2093,2248,2491
2079,ostre,29,19,10,2093,2518,1614
2080,jist,29,25,4,2093,1810,6130
2081,pirati,29,7,22,2093,7246,424
2082,komentoval,29,15,14,2093,3239,913
2083,urovne,29,20,9,2093,2376,1924
2084,sla,29,23,6,2093,2024,4065
2085,pozadi,29,16,13,2093,3019,1036
2086,agent,29,19,10,2093,2518,1614
2087,oblastech,29,27,2,2093,1662,10331
2088,obci,29,24,5,2093,1911,5101
2089,hospodarky,29,29,0,2093,1505,49779
2090,potazmo,29,23,6,2093,2024,4065
2091,uctu,29,19,10,2093,2518,1614
2092,vezeni,29,22,7,2093,2135,3140
2093,postavili,29,23,6,2093,2024,4065
2094,tlakem,29,25,4,2093,1810,6130
2095,snemovne,29,23,6,2093,2024,4065
2096,valecne,29,26,3,2093,1729,7493
2097,madarsky,29,20,9,2093,2376,1924
2098,ekonomiku,29,25,4,2093,1810,6130
2099,nasazeni,29,23,6,2093,2024,4065
2100,studie,29,29,0,2093,1505,49779
2101,odlozit,29,28,1,2093,1582,20221
2102,budoucna,29,19,10,2093,2518,1614
2103,americany,29,25,4,2093,1810,6130
2104,radioaktivnich,29,25,4,2093,1810,6130
2105,iii,29,21,8,2093,2248,2491
2106,daji,29,23,6,2093,2024,4065
2107,porovnani,29,16,13,2093,3019,1036
2108,silnejsi,29,22,7,2093,2135,3140
2109,dopadne,29,24,5,2093,1911,5101
2110,velmoc,29,24,5,2093,1911,5101
2111,nebudeme,29,26,3,2093,1729,7493
2112,energeticka,29,25,4,2093,1810,6130
2113,mladych,29,16,13,2093,3019,1036
2114,migracni,29,28,1,2093,1582,20221
2115,pavla,29,27,2,2093,1662,10331
2116,spusteni,29,23,6,2093,2024,4065
2117,prvniho,29,26,3,2093,1729,7493
2118,zdroji,29,29,0,2093,1505,49779
2119,hovno,29,14,15,2093,3490,809
2120,nelibi,29,22,7,2093,2135,3140
2121,poslanci,29,27,2,2093,1662,10331
2122,reditel,29,16,13,2093,3019,1036
2123,mwh,29,25,4,2093,1810,6130
2124,dopad,29,26,3,2093,1729,7493
2125,blbost,29,20,9,2093,2376,1924
2126,musis,29,12,17,2093,4133,666
2127,matky,29,19,10,2093,2518,1614
2128,nuclear,29,28,1,2093,1582,20221
2129,kdybyste,29,17,12,2093,2828,1179
2130,izraele,29,27,2,2093,1662,10331
2131,malem,29,17,12,2093,2828,1179
2132,zustane,29,21,8,2093,2248,2491
2133,provadi,29,25,4,2093,1810,6130
2134,mostu,29,16,13,2093,3019,1036
2135,sa,29,22,7,2093,2135,3140
2136,blbosti,29,20,9,2093,2376,1924
2137,nasel,29,25,4,2093,1810,6130
2138,vasich,29,15,14,2093,3239,913
2139,poslednim,29,21,8,2093,2248,2491
2140,hlave,28,22,6,2184,2135,4065
2141,hitlera,28,17,11,2184,2828,1363
2142,httpswwwrespektczspolecnostnovakovahradstriktnetrvanastavbejadernychblokualemeneukoluje,28,27,1,2184,1662,20221
2143,boje,28,25,3,2184,1810,7493
2144,odpovi,28,20,8,2184,2376,2491
2145,dokazal,28,24,4,2184,1911,6130
2146,list,28,23,5,2184,2024,5101
2147,zdarma,28,20,8,2184,2376,2491
2148,totalne,28,23,5,2184,2024,5101
2149,tveho,28,13,15,2184,3784,809
2150,motoru,28,28,0,2184,1582,49779
2151,ukrajinou,28,20,8,2184,2376,2491
2152,testy,28,23,5,2184,2024,5101
2153,postoj,28,21,7,2184,2248,3140
2154,motor,28,22,6,2184,2135,4065
2155,fukusime,28,27,1,2184,1662,20221
2156,navzdory,28,18,10,2184,2661,1614
2157,dejinach,28,19,9,2184,2518,1924
2158,lokalni,28,27,1,2184,1662,20221
2159,pisi,28,23,5,2184,2024,5101
2160,prirodni,28,25,3,2184,1810,7493
2161,kostce,28,28,0,2184,1582,49779
2162,rusaky,28,23,5,2184,2024,5101
2163,webu,28,21,7,2184,2248,3140
2164,jakysi,28,15,13,2184,3239,1036
2165,nedokazali,28,12,16,2184,4133,727
2166,aliance,28,24,4,2184,1911,6130
2167,prezidentmluvci,28,27,1,2184,1662,20221
2168,napad,28,16,12,2184,3019,1179
2169,of,28,18,10,2184,2661,1614
2170,prve,28,19,9,2184,2518,1924
2171,budovat,28,25,3,2184,1810,7493
2172,planetu,28,24,4,2184,1911,6130
2173,turecko,28,25,3,2184,1810,7493
2174,obema,28,16,12,2184,3019,1179
2175,vysvetlili,28,23,5,2184,2024,5101
2176,informuje,28,17,11,2184,2828,1363
2177,urady,28,24,4,2184,1911,6130
2178,dalnice,28,26,2,2184,1729,10331
2179,vlaku,28,19,9,2184,2518,1924
2180,tricet,28,19,9,2184,2518,1924
2181,funkcni,28,24,4,2184,1911,6130
2182,vyvijet,28,27,1,2184,1662,20221
2183,chlazeni,28,28,0,2184,1582,49779
2184,vyviji,28,23,5,2184,2024,5101
2185,experti,28,21,7,2184,2248,3140
2186,zkusit,28,17,11,2184,2828,1363
2187,vlivem,28,19,9,2184,2518,1924
2188,ranni,28,24,4,2184,1911,6130
2189,dobrovolne,28,26,2,2184,1729,10331
2190,nakladu,28,23,5,2184,2024,5101
2191,pracovni,28,17,11,2184,2828,1363
2192,tydny,28,20,8,2184,2376,2491
2193,zarenim,28,28,0,2184,1582,49779
2194,teorii,28,22,6,2184,2135,4065
2195,regionu,28,21,7,2184,2248,3140
2196,jejiho,28,26,2,2184,1729,10331
2197,pohon,28,28,0,2184,1582,49779
2198,mozny,28,24,4,2184,1911,6130
2199,vojenskeho,28,20,8,2184,2376,2491
2200,nastane,28,27,1,2184,1662,20221
2201,vyjadril,28,21,7,2184,2248,3140
2202,stroje,28,24,4,2184,1911,6130
2203,putinovi,28,25,3,2184,1810,7493
2204,potencialni,28,22,6,2184,2135,4065
2205,odpovedel,28,18,10,2184,2661,1614
2206,vedenim,28,22,6,2184,2135,4065
2207,mezitim,28,27,1,2184,1662,20221
2208,spalovaci,28,28,0,2184,1582,49779
2209,stavebni,28,26,2,2184,1729,10331
2210,vojaky,28,25,3,2184,1810,7493
2211,zustala,28,14,14,2184,3490,913
2212,donbas,28,15,13,2184,3239,1036
2213,strategii,28,23,5,2184,2024,5101
2214,nutno,28,18,10,2184,2661,1614
2215,pomeru,28,18,10,2184,2661,1614
2216,puvodu,28,17,11,2184,2828,1363
2217,receno,28,22,6,2184,2135,4065
2218,techniky,28,25,3,2184,1810,7493
2219,automobilu,28,20,8,2184,2376,2491
2220,kvalitni,28,17,11,2184,2828,1363
2221,jedu,28,20,8,2184,2376,2491
2222,prikladu,28,19,9,2184,2518,1924
2223,socialnich,28,20,8,2184,2376,2491
2224,zamer,28,23,5,2184,2024,5101
2225,temito,28,26,2,2184,1729,10331
2226,pripadu,28,20,8,2184,2376,2491
2227,italie,28,24,4,2184,1911,6130
2228,kreml,27,21,6,2284,2248,4065
2229,text,27,20,7,2284,2376,3140
2230,trikrat,27,12,15,2284,4133,809
2231,pokazde,27,18,9,2284,2661,1924
2232,naproste,27,16,11,2284,3019,1363
2233,zavest,27,16,11,2284,3019,1363
2234,tendru,27,24,3,2284,1911,7493
2235,noviny,27,15,12,2284,3239,1179
2236,logiku,27,24,3,2284,1911,7493
2237,zavedeni,27,14,13,2284,3490,1036
2238,prestane,27,17,10,2284,2828,1614
2239,jednak,27,18,9,2284,2661,1924
2240,cenou,27,25,2,2284,1810,10331
2241,rozvedky,27,22,5,2284,2135,5101
2242,vetsiny,27,18,9,2284,2661,1924
2243,skupinacez,27,26,1,2284,1729,20221
2244,dobach,27,19,8,2284,2518,2491
2245,nasilne,27,14,13,2284,3490,1036
2246,houby,27,22,5,2284,2135,5101
2247,zaver,27,23,4,2284,2024,6130
2248,realizace,27,19,8,2284,2518,2491
2249,planuji,27,21,6,2284,2248,4065
2250,cinske,27,22,5,2284,2135,5101
2251,spoluprace,27,25,2,2284,1810,10331
2252,zmen,27,25,2,2284,1810,10331
2253,klubu,27,19,8,2284,2518,2491
2254,cleny,27,24,3,2284,1911,7493
2255,rodin,27,16,11,2284,3019,1363
2256,drtiva,27,24,3,2284,1911,7493
2257,malych,27,17,10,2284,2828,1614
2258,vyresi,27,27,0,2284,1662,49779
2259,clenu,27,23,4,2284,2024,6130
2260,skutecny,27,24,3,2284,1911,7493
2261,podrobnosti,27,19,8,2284,2518,2491
2262,obcanske,27,14,13,2284,3490,1036
2263,tvari,27,13,14,2284,3784,913
2264,domy,27,17,10,2284,2828,1614
2265,ekonomickou,27,22,5,2284,2135,5101
2266,ctete,27,23,4,2284,2024,6130
2267,uvadi,27,24,3,2284,1911,7493
2268,spojeni,27,18,9,2284,2661,1924
2269,arzenal,27,27,0,2284,1662,49779
2270,pratele,27,18,9,2284,2661,1924
2271,balisticke,27,24,3,2284,1911,7493
2272,lez,27,22,5,2284,2135,5101
2273,slibil,27,20,7,2284,2376,3140
2274,stejna,27,26,1,2284,1729,20221
2275,zivych,27,26,1,2284,1729,20221
2276,nemely,27,18,9,2284,2661,1924
2277,myslet,27,22,5,2284,2135,5101
2278,hrozby,27,25,2,2284,1810,10331
2279,kratsi,27,19,8,2284,2518,2491
2280,desetileti,27,25,2,2284,1810,10331
2281,pekla,27,22,5,2284,2135,5101
2282,prevahu,27,19,8,2284,2518,2491
2283,hur,27,15,12,2284,3239,1179
2284,hloupost,27,12,15,2284,4133,809
2285,druhem,27,19,8,2284,2518,2491
2286,prilezitosti,27,22,5,2284,2135,5101
2287,zapomnel,27,15,12,2284,3239,1179
2288,silny,27,18,9,2284,2661,1924
2289,plneni,27,14,13,2284,3490,1036
2290,obamovi,27,23,4,2284,2024,6130
2291,ksc,27,14,13,2284,3490,1036
2292,neprijatelne,27,16,11,2284,3019,1363
2293,nemyslel,27,19,8,2284,2518,2491
2294,madarska,27,24,3,2284,1911,7493
2295,vymenit,27,18,9,2284,2661,1924
2296,bojove,27,16,11,2284,3019,1363
2297,obrovskou,27,26,1,2284,1729,20221
2298,vypadalo,27,17,10,2284,2828,1614
2299,dnu,27,23,4,2284,2024,6130
2300,zbyva,27,23,4,2284,2024,6130
2301,coby,27,16,11,2284,3019,1363
2302,skolstvi,27,13,14,2284,3784,913
2303,jasna,27,20,7,2284,2376,3140
2304,efekt,27,22,5,2284,2135,5101
2305,svazu,27,22,5,2284,2135,5101
2306,dulezita,27,23,4,2284,2024,6130
2307,velitel,27,17,10,2284,2828,1614
2308,podobnych,27,21,6,2284,2248,4065
2309,gru,27,20,7,2284,2376,3140
2310,letadlo,27,22,5,2284,2135,5101
2311,komunistu,27,13,14,2284,3784,913
2312,nemuzeme,27,24,3,2284,1911,7493
2313,state,27,17,10,2284,2828,1614
2314,noc,27,17,10,2284,2828,1614
2315,milose,27,20,7,2284,2376,3140
2316,puvodni,27,23,4,2284,2024,6130
2317,jistotu,27,23,4,2284,2024,6130
2318,tezky,27,16,11,2284,3019,1363
2319,zajimavy,27,22,5,2284,2135,5101
2320,dopravy,27,15,12,2284,3239,1179
2321,kwh,27,27,0,2284,1662,49779
2322,prirode,27,25,2,2284,1810,10331
2323,vseobecne,27,15,12,2284,3239,1179
2324,strategickych,27,23,4,2284,2024,6130
2325,rozmistit,27,27,0,2284,1662,49779
2326,vyrok,27,21,6,2284,2248,4065
2327,svobodu,27,15,12,2284,3239,1179
2328,radar,27,22,5,2284,2135,5101
2329,porusuji,27,25,2,2284,1810,10331
2330,odstaveni,27,21,6,2284,2248,4065
2331,rozhodnout,27,22,5,2284,2135,5101
2332,madarsko,27,17,10,2284,2828,1614
2333,podani,27,19,8,2284,2518,2491
2334,opak,27,24,3,2284,1911,7493
2335,prilezitost,27,9,18,2284,5608,605
2336,kraji,27,15,12,2284,3239,1179
2337,realizovat,27,25,2,2284,1810,10331
2338,zrusil,27,16,11,2284,3019,1363
2339,oboji,27,6,21,2284,8443,459
2340,odveta,26,26,0,2394,1729,49779
2341,resenim,26,24,2,2394,1911,10331
2342,rocni,26,21,5,2394,2248,5101
2343,banky,26,19,7,2394,2518,3140
2344,shromazdeni,26,18,8,2394,2661,2491
2345,tandem,26,25,1,2394,1810,20221
2346,kdepak,26,16,10,2394,3019,1614
2347,dokazali,26,23,3,2394,2024,7493
2348,kalousek,26,8,18,2394,6340,605
2349,hrube,26,12,14,2394,4133,913
2350,znameni,26,12,14,2394,4133,913
2351,clenstvi,26,17,9,2394,2828,1924
2352,bakalovi,26,26,0,2394,1729,49779
2353,ohrozuje,26,22,4,2394,2135,6130
2354,centru,26,22,4,2394,2135,6130
2355,plynove,26,24,2,2394,1911,10331
2356,tezce,26,20,6,2394,2376,4065
2357,nejprve,26,18,8,2394,2661,2491
2358,znam,26,12,14,2394,4133,913
2359,umet,26,18,8,2394,2661,2491
2360,merkelove,26,22,4,2394,2135,6130
2361,mladsi,26,10,16,2394,5017,727
2362,vedouci,26,19,7,2394,2518,3140
2363,slunecni,26,26,0,2394,1729,49779
2364,informovali,26,15,11,2394,3239,1363
2365,velvyslanec,26,15,11,2394,3239,1363
2366,clintonovym,26,22,4,2394,2135,6130
2367,priznat,26,24,2,2394,1911,10331
2368,mest,26,21,5,2394,2248,5101
2369,uspech,26,12,14,2394,4133,913
2370,kauza,26,23,3,2394,2024,7493
2371,vetsinove,26,15,11,2394,3239,1363
2372,delal,26,15,11,2394,3239,1363
2373,jakekoli,26,23,3,2394,2024,7493
2374,tiskove,26,13,13,2394,3784,1036
2375,clovekem,26,15,11,2394,3239,1363
2376,logicke,26,24,2,2394,1911,10331
2377,zvysovat,26,20,6,2394,2376,4065
2378,mnohokrat,26,13,13,2394,3784,1036
2379,svedci,26,22,4,2394,2135,6130
2380,zdravotni,26,14,12,2394,3490,1179
2381,most,26,19,7,2394,2518,3140
2382,demokraty,26,24,2,2394,1911,10331
2383,merkelova,26,22,4,2394,2135,6130
2384,deseti,26,21,5,2394,2248,5101
2385,nynejsi,26,21,5,2394,2248,5101
2386,necemu,26,13,13,2394,3784,1036
2387,byva,26,15,11,2394,3239,1363
2388,chapete,26,22,4,2394,2135,6130
2389,radiace,26,24,2,2394,1911,10331
2390,tajemstvi,26,16,10,2394,3019,1614
2391,vasim,26,12,14,2394,4133,913
2392,sovetske,26,23,3,2394,2024,7493
2393,nohavicovi,26,26,0,2394,1729,49779
2394,pripomenout,26,24,2,2394,1911,10331
2395,soudu,26,18,8,2394,2661,2491
2396,neexistuji,26,22,4,2394,2135,6130
2397,predvedl,26,15,11,2394,3239,1363
2398,zustat,26,22,4,2394,2135,6130
2399,ctu,26,11,15,2394,4527,809
2400,hlavicemi,26,25,1,2394,1810,20221
2401,terorismu,26,16,10,2394,3019,1614
2402,polovina,26,24,2,2394,1911,10331
2403,zpusobi,26,26,0,2394,1729,49779
2404,radek,26,24,2,2394,1911,10331
2405,obrovsky,26,22,4,2394,2135,6130
2406,vyznamenani,26,24,2,2394,1911,10331
2407,cituji,26,22,4,2394,2135,6130
2408,divit,26,18,8,2394,2661,2491
2409,paliv,26,26,0,2394,1729,49779
2410,svaz,26,19,7,2394,2518,3140
2411,strategicke,26,26,0,2394,1729,49779
2412,oborech,26,17,9,2394,2828,1924
2413,karel,26,17,9,2394,2828,1924
2414,najevo,26,23,3,2394,2024,7493
2415,kapitalismus,26,20,6,2394,2376,4065
2416,dusledky,26,23,3,2394,2024,7493
2417,svobody,26,17,9,2394,2828,1924
2418,statum,26,21,5,2394,2248,5101
2419,predsedy,26,16,10,2394,3019,1614
2420,hlavou,26,20,6,2394,2376,4065
2421,vyhrozuji,26,22,4,2394,2135,6130
2422,dukaz,26,24,2,2394,1911,10331
2423,kosmickeho,26,20,6,2394,2376,4065
2424,pripraven,26,16,10,2394,3019,1614
2425,zahranicnich,26,24,2,2394,1911,10331
2426,hubu,26,8,18,2394,6340,605
2427,mlady,26,14,12,2394,3490,1179
2428,vydrzi,26,20,6,2394,2376,4065
2429,doprava,26,20,6,2394,2376,4065
2430,neplati,26,24,2,2394,1911,10331
2431,stanice,26,20,6,2394,2376,4065
2432,tamni,26,21,5,2394,2248,5101
2433,baterii,26,24,2,2394,1911,10331
2434,point,26,25,1,2394,1810,20221
2435,dokonale,26,19,7,2394,2518,3140
2436,volba,26,14,12,2394,3490,1179
2437,slib,26,18,8,2394,2661,2491
2438,zaplatit,26,24,2,2394,1911,10331
2439,tydnech,26,26,0,2394,1729,49779
2440,studena,26,17,9,2394,2828,1924
2441,mluvci,26,26,0,2394,1729,49779
2442,dokumenty,26,13,13,2394,3784,1036
2443,tajnych,26,24,2,2394,1911,10331
2444,seznamu,26,21,5,2394,2248,5101
2445,dnech,26,21,5,2394,2248,5101
2446,rakete,26,19,7,2394,2518,3140
2447,arzenalu,26,24,2,2394,1911,10331
2448,dolet,25,25,0,2505,1810,49779
2449,platy,25,17,8,2505,2828,2491
2450,stesti,25,17,8,2505,2828,2491
2451,zadarmo,25,22,3,2505,2135,7493
2452,socialismu,25,17,8,2505,2828,2491
2453,ukrajinskych,25,15,10,2505,3239,1614
2454,dokumentaci,25,25,0,2505,1810,49779
2455,okundra,25,23,2,2505,2024,10331
2456,ustavy,25,15,10,2505,3239,1614
2457,mpotweetuje,25,24,1,2505,1911,20221
2458,snizit,25,24,1,2505,1911,20221
2459,britska,25,21,4,2505,2248,6130
2460,statnich,25,23,2,2505,2024,10331
2461,prosadit,25,23,2,2505,2024,10331
2462,zacinaji,25,17,8,2505,2828,2491
2463,iskander,25,21,4,2505,2248,6130
2464,ukrajinsti,25,15,10,2505,3239,1614
2465,panelu,25,25,0,2505,1810,49779
2466,ukrajinskeho,25,16,9,2505,3019,1924
2467,michal,25,15,10,2505,3239,1614
2468,pises,25,16,9,2505,3019,1924
2469,obcan,25,13,12,2505,3784,1179
2470,planuje,25,23,2,2505,2024,10331
2471,odpadem,25,25,0,2505,1810,49779
2472,ss,25,20,5,2505,2376,5101
2473,civilni,25,21,4,2505,2248,6130
2474,dovolim,25,15,10,2505,3239,1614
2475,patnacti,25,14,11,2505,3490,1363
2476,novinari,25,16,9,2505,3019,1924
2477,zautocit,25,17,8,2505,2828,2491
2478,uran,25,20,5,2505,2376,5101
2479,jinemu,25,23,2,2505,2024,10331
2480,ukaze,25,20,5,2505,2376,5101
2481,neveri,25,21,4,2505,2248,6130
2482,dodavek,25,19,6,2505,2518,4065
2483,nevidim,25,18,7,2505,2661,3140
2484,cekaji,25,19,6,2505,2518,4065
2485,donecke,25,10,15,2505,5017,809
2486,zalezitost,25,20,5,2505,2376,5101
2487,donald,25,21,4,2505,2248,6130
2488,zakladnu,25,21,4,2505,2248,6130
2489,najde,25,20,5,2505,2376,5101
2490,diskutovat,25,20,5,2505,2376,5101
2491,brno,25,21,4,2505,2248,6130
2492,hre,25,22,3,2505,2135,7493
2493,dob,25,19,6,2505,2518,4065
2494,pisu,25,14,11,2505,3490,1363
2495,zastupci,25,20,5,2505,2376,5101
2496,stovek,25,23,2,2505,2024,10331
2497,david,25,14,11,2505,3490,1363
2498,jedinym,25,23,2,2505,2024,10331
2499,zbavit,25,23,2,2505,2024,10331
2500,zaslouzi,25,23,2,2505,2024,10331
2501,rostouci,25,23,2,2505,2024,10331
2502,dostalo,25,18,7,2505,2661,3140
2503,minuleho,25,21,4,2505,2248,6130
2504,sportovni,25,22,3,2505,2135,7493
2505,start,25,25,0,2505,1810,49779
2506,rozkaz,25,23,2,2505,2024,10331
2507,sovetskeho,25,22,3,2505,2135,7493
2508,mrtvych,25,15,10,2505,3239,1614
2509,jinam,25,12,13,2505,4133,1036
2510,vetrnych,25,24,1,2505,1911,20221
2511,times,25,18,7,2505,2661,3140
2512,vode,25,21,4,2505,2248,6130
2513,letecke,25,21,4,2505,2248,6130
2514,predem,25,18,7,2505,2661,3140
2515,prislo,25,18,7,2505,2661,3140
2516,vojak,25,18,7,2505,2661,3140
2517,zmatek,25,17,8,2505,2828,2491
2518,bombardovani,25,22,3,2505,2135,7493
2519,lete,25,17,8,2505,2828,2491
2520,bavit,25,23,2,2505,2024,10331
2521,predstavuje,25,20,5,2505,2376,5101
2522,hdp,25,20,5,2505,2376,5101
2523,kratke,25,12,13,2505,4133,1036
2524,napadlo,25,12,13,2505,4133,1036
2525,nemuzes,25,16,9,2505,3019,1924
2526,krom,25,21,4,2505,2248,6130
2527,nerozumim,25,15,10,2505,3239,1614
2528,znici,25,24,1,2505,1911,20221
2529,vrazdy,25,17,8,2505,2828,2491
2530,ucinnost,25,23,2,2505,2024,10331
2531,lidech,25,18,7,2505,2661,3140
2532,banka,25,14,11,2505,3490,1363
2533,zpusoby,25,16,9,2505,3019,1924
2534,povede,25,15,10,2505,3239,1614
2535,aj,25,19,6,2505,2518,4065
2536,pripadech,25,22,3,2505,2135,7493
2537,postup,25,20,5,2505,2376,5101
2538,agentury,25,24,1,2505,1911,20221
2539,zduraznil,25,23,2,2505,2024,10331
2540,zemannejedly,25,25,0,2505,1810,49779
2541,laska,25,10,15,2505,5017,809
2542,prestaly,25,18,7,2505,2661,3140
2543,rychleji,25,19,6,2505,2518,4065
2544,nenavist,25,13,12,2505,3784,1179
2545,vyjde,25,24,1,2505,1911,20221
2546,pravidel,25,22,3,2505,2135,7493
2547,kavicce,25,21,4,2505,2248,6130
2548,severu,25,22,3,2505,2135,7493
2549,samy,25,20,5,2505,2376,5101
2550,kyjeva,25,14,11,2505,3490,1363
2551,korea,25,23,2,2505,2024,10331
2552,poslanec,25,12,13,2505,4133,1036
2553,pokusu,25,24,1,2505,1911,20221
2554,nemyslite,25,13,12,2505,3784,1179
2555,porosenko,25,16,9,2505,3019,1924
2556,sefa,25,12,13,2505,4133,1036
2557,potize,25,12,13,2505,4133,1036
2558,napadnout,25,24,1,2505,1911,20221
2559,tv,25,21,4,2505,2248,6130
2560,kim,25,25,0,2505,1810,49779
2561,rozhodla,24,18,6,2623,2661,4065
2562,experiment,24,17,7,2623,2828,3140
2563,pochopil,24,17,7,2623,2828,3140
2564,oznaceni,24,19,5,2623,2518,5101
2565,zrusi,24,15,9,2623,3239,1924
2566,ekonomickych,24,16,8,2623,3019,2491
2567,hra,24,19,5,2623,2518,5101
2568,vytvori,24,15,9,2623,3239,1924
2569,rec,24,12,12,2623,4133,1179
2570,napsano,24,14,10,2623,3490,1614
2571,videli,24,13,11,2623,3784,1363
2572,stanici,24,15,9,2623,3239,1924
2573,samotneho,24,21,3,2623,2248,7493
2574,odpor,24,11,13,2623,4527,1036
2575,ctvrty,24,20,4,2623,2376,6130
2576,tepla,24,16,8,2623,3019,2491
2577,volice,24,11,13,2623,4527,1036
2578,nepozve,24,24,0,2623,1911,49779
2579,jednalo,24,24,0,2623,1911,49779
2580,nasa,24,22,2,2623,2135,10331
2581,udelaji,24,19,5,2623,2518,5101
2582,prazske,24,16,8,2623,3019,2491
2583,vlak,24,14,10,2623,3490,1614
2584,planeta,24,23,1,2623,2024,20221
2585,belorusko,24,17,7,2623,2828,3140
2586,fakticky,24,21,3,2623,2248,7493
2587,padem,24,21,3,2623,2248,7493
2588,samotne,24,23,1,2623,2024,20221
2589,hnusne,24,24,0,2623,1911,49779
2590,zadal,24,16,8,2623,3019,2491
2591,konstrukce,24,24,0,2623,1911,49779
2592,info,24,19,5,2623,2518,5101
2593,httpswwwnovinkyczekonomikazemansporadcipodporilijadroiprolomenitezebnichlimituhtml,24,24,0,2623,1911,49779
2594,vysoko,24,15,9,2623,3239,1924
2595,skripal,24,19,5,2623,2518,5101
2596,nefunguje,24,13,11,2623,3784,1363
2597,uvedla,24,21,3,2623,2248,7493
2598,leda,24,13,11,2623,3784,1363
2599,propagandy,24,10,14,2623,5017,913
2600,pocty,24,15,9,2623,3239,1924
2601,koncem,24,20,4,2623,2376,6130
2602,aktivni,24,16,8,2623,3019,2491
2603,vysokeho,24,16,8,2623,3019,2491
2604,odpovim,24,10,14,2623,5017,913
2605,trvale,24,21,3,2623,2248,7493
2606,protiruske,24,15,9,2623,3239,1924
2607,trumpova,24,19,5,2623,2518,5101
2608,hradni,24,17,7,2623,2828,3140
2609,odpovida,24,22,2,2623,2135,10331
2610,sehnat,24,15,9,2623,3239,1924
2611,pravomoci,24,16,8,2623,3019,2491
2612,prolomit,24,24,0,2623,1911,49779
2613,cteni,24,21,3,2623,2248,7493
2614,reality,24,18,6,2623,2661,4065
2615,prodej,24,22,2,2623,2135,10331
2616,pobrezi,24,21,3,2623,2248,7493
2617,mise,24,17,7,2623,2828,3140
2618,popisuje,24,23,1,2623,2024,20221
2619,volbami,24,16,8,2623,3019,2491
2620,nizke,24,18,6,2623,2661,4065
2621,chodit,24,11,13,2623,4527,1036
2622,kupovat,24,19,5,2623,2518,5101
2623,pral,24,8,16,2623,6340,727
2624,katastrofalni,24,23,1,2623,2024,20221
2625,rozpocet,24,24,0,2623,1911,49779
2626,soucasny,24,20,4,2623,2376,6130
2627,pripomenme,24,16,8,2623,3019,2491
2628,panu,24,16,8,2623,3019,2491
2629,hloupe,24,11,13,2623,4527,1036
2630,dokola,24,17,7,2623,2828,3140
2631,schvaleni,24,15,9,2623,3239,1924
2632,schopnost,24,19,5,2623,2518,5101
2633,vysvetlil,24,17,7,2623,2828,3140
2634,schuzku,24,23,1,2623,2024,20221
2635,obrovska,24,22,2,2623,2135,10331
2636,neznalost,24,14,10,2623,3490,1614
2637,fosilni,24,24,0,2623,1911,49779
2638,technologicky,24,23,1,2623,2024,20221
2639,socialisticke,24,17,7,2623,2828,3140
2640,palube,24,17,7,2623,2828,3140
2641,nazev,24,16,8,2623,3019,2491
2642,ziskali,24,22,2,2623,2135,10331
2643,podporuje,24,22,2,2623,2135,10331
2644,preventivnim,24,18,6,2623,2661,4065
2645,lobby,24,23,1,2623,2024,20221
2646,tunelu,24,16,8,2623,3019,2491
2647,energetickeho,24,23,1,2623,2024,20221
2648,hloupy,24,7,17,2623,7246,666
2649,dostava,24,20,4,2623,2376,6130
2650,internet,24,17,7,2623,2828,3140
2651,tesne,24,20,4,2623,2376,6130
2652,organizovat,24,24,0,2623,1911,49779
2653,spotrebu,24,19,5,2623,2518,5101
2654,vety,24,13,11,2623,3784,1363
2655,nejnovejsi,24,21,3,2623,2248,7493
2656,vystavbou,24,15,9,2623,3239,1924
2657,tehdejsi,24,20,4,2623,2376,6130
2658,nicim,24,15,9,2623,3239,1924
2659,vzor,24,12,12,2623,4133,1179
2660,planovani,24,15,9,2623,3239,1924
2661,padu,24,13,11,2623,3784,1363
2662,bavi,24,12,12,2623,4133,1179
2663,necem,24,19,5,2623,2518,5101
2664,zen,24,19,5,2623,2518,5101
2665,metal,24,23,1,2623,2024,20221
2666,pronesl,24,23,1,2623,2024,20221
2667,vlast,24,14,10,2623,3490,1614
2668,zahynulo,24,18,6,2623,2661,4065
2669,blizkem,24,12,12,2623,4133,1179
2670,sleduji,24,20,4,2623,2376,6130
2671,uprimne,24,13,11,2623,3784,1363
2672,nabizi,24,15,9,2623,3239,1924
2673,lasky,24,16,8,2623,3019,2491
2674,nedoslo,24,22,2,2623,2135,10331
2675,organy,24,12,12,2623,4133,1179
2676,otazce,24,20,4,2623,2376,6130
2677,panely,24,21,3,2623,2248,7493
2678,dojem,24,19,5,2623,2518,5101
2679,blaboly,24,13,11,2623,3784,1363
2680,predchozich,24,12,12,2623,4133,1179
2681,smutnou,24,17,7,2623,2828,3140
2682,suroviny,24,24,0,2623,1911,49779
2683,nejvetsich,24,17,7,2623,2828,3140
2684,dna,24,21,3,2623,2248,7493
2685,varuje,23,13,10,2741,3784,1614
2686,ropa,23,19,4,2741,2518,6130
2687,vesnice,23,12,11,2741,4133,1363
2688,samo,23,9,14,2741,5608,913
2689,klesat,23,16,7,2741,3019,3140
2690,kruhu,23,12,11,2741,4133,1363
2691,prd,23,17,6,2741,2828,4065
2692,filmu,23,21,2,2741,2248,10331
2693,vyhral,23,15,8,2741,3239,2491
2694,upravy,23,14,9,2741,3490,1924
2695,fin,23,23,0,2741,2024,49779
2696,neovlivnicz,23,23,0,2741,2024,49779
2697,nejdriv,23,16,7,2741,3019,3140
2698,irak,23,21,2,2741,2248,10331
2699,bojovych,23,22,1,2741,2135,20221
2700,svetovy,23,22,1,2741,2135,20221
2701,svetovych,23,18,5,2741,2661,5101
2702,celych,23,10,13,2741,5017,1036
2703,svetoveho,23,21,2,2741,2248,10331
2704,davaji,23,16,7,2741,3019,3140
2705,udaje,23,18,5,2741,2661,5101
2706,komunisty,23,10,13,2741,5017,1036
2707,bydleni,23,13,10,2741,3784,1614
2708,omyl,23,17,6,2741,2828,4065
2709,zraneni,23,13,10,2741,3784,1614
2710,hodnotit,23,11,12,2741,4527,1179
2711,polovinu,23,21,2,2741,2248,10331
2712,kscm,23,13,10,2741,3784,1614
2713,vybudovat,23,21,2,2741,2248,10331
2714,trestni,23,11,12,2741,4527,1179
2715,stopy,23,16,7,2741,3019,3140
2716,ruky,23,17,6,2741,2828,4065
2717,pokracovani,23,20,3,2741,2376,7493
2718,klaus,23,12,11,2741,4133,1363
2719,dokumentu,23,21,2,2741,2248,10331
2720,verejnosti,23,19,4,2741,2518,6130
2721,predstavu,23,22,1,2741,2135,20221
2722,danrisingup,23,23,0,2741,2024,49779
2723,pate,23,9,14,2741,5608,913
2724,vlasti,23,18,5,2741,2661,5101
2725,pravdou,23,12,11,2741,4133,1363
2726,ukolu,23,17,6,2741,2828,4065
2727,httppictwittercompaszhfw,23,23,0,2741,2024,49779
2728,historicke,23,20,3,2741,2376,7493
2729,jih,23,16,7,2741,3019,3140
2730,projev,23,17,6,2741,2828,4065
2731,rozumu,23,19,4,2741,2518,6130
2732,ivan,23,16,7,2741,3019,3140
2733,samotny,23,18,5,2741,2661,5101
2734,nechali,23,12,11,2741,4133,1363
2735,ptam,23,9,14,2741,5608,913
2736,kontrole,23,15,8,2741,3239,2491
2737,faze,23,10,13,2741,5017,1036
2738,nemohli,23,18,5,2741,2661,5101
2739,vetsim,23,19,4,2741,2518,6130
2740,bezi,23,20,3,2741,2376,7493
2741,prumyslove,23,18,5,2741,2661,5101
2742,spocivajici,23,22,1,2741,2135,20221
2743,materialy,23,22,1,2741,2135,20221
2744,trvaleho,23,23,0,2741,2024,49779
2745,ekonomickeho,23,17,6,2741,2828,4065
2746,lidu,23,13,10,2741,3784,1614
2747,generaci,23,19,4,2741,2518,6130
2748,dlouha,23,19,4,2741,2518,6130
2749,motory,23,22,1,2741,2135,20221
2750,vznikla,23,17,6,2741,2828,4065
2751,tomas,23,21,2,2741,2248,10331
2752,euro,23,12,11,2741,4133,1363
2753,vztah,23,18,5,2741,2661,5101
2754,zmena,23,18,5,2741,2661,5101
2755,zdali,23,12,11,2741,4133,1363
2756,unii,23,15,8,2741,3239,2491
2757,ziskal,23,21,2,2741,2248,10331
2758,dopravu,23,18,5,2741,2661,5101
2759,vznik,23,17,6,2741,2828,4065
2760,vysetrovaci,23,16,7,2741,3019,3140
2761,uhlobarona,23,23,0,2741,2024,49779
2762,kdokoliv,23,13,10,2741,3784,1614
2763,dil,23,16,7,2741,3019,3140
2764,vhodne,23,21,2,2741,2248,10331
2765,nechceme,23,19,4,2741,2518,6130
2766,oddeleni,23,23,0,2741,2024,49779
2767,zavazali,23,22,1,2741,2135,20221
2768,organizaci,23,21,2,2741,2248,10331
2769,energiewende,23,18,5,2741,2661,5101
2770,kanalu,23,14,9,2741,3490,1924
2771,celku,23,17,6,2741,2828,4065
2772,osoby,23,20,3,2741,2376,7493
2773,sance,23,17,6,2741,2828,4065
2774,realitu,23,20,3,2741,2376,7493
2775,striktne,23,22,1,2741,2135,20221
2776,vyzkouset,23,14,9,2741,3490,1924
2777,alexandr,23,15,8,2741,3239,2491
2778,bolseviku,23,10,13,2741,5017,1036
2779,zanedbatelne,23,10,13,2741,5017,1036
2780,prav,23,17,6,2741,2828,4065
2781,vyroky,23,16,7,2741,3019,3140
2782,tykace,23,23,0,2741,2024,49779
2783,vizi,23,20,3,2741,2376,7493
2784,cloveku,23,13,10,2741,3784,1614
2785,zabyvat,23,19,4,2741,2518,6130
2786,videa,23,16,7,2741,3019,3140
2787,biologicke,23,20,3,2741,2376,7493
2788,uvazovat,23,21,2,2741,2248,10331
2789,nepujde,23,14,9,2741,3490,1924
2790,existovat,23,20,3,2741,2376,7493
2791,tykac,23,23,0,2741,2024,49779
2792,vetrniky,23,19,4,2741,2518,6130
2793,znate,23,12,11,2741,4133,1363
2794,silenstvi,23,11,12,2741,4527,1179
2795,letectva,23,14,9,2741,3490,1924
2796,zminil,22,18,4,2877,2661,6130
2797,nasla,22,21,1,2877,2248,20221
2798,nabidka,22,20,2,2877,2376,10331
2799,stastny,22,7,15,2877,7246,809
2800,nemeckeho,22,20,2,2877,2376,10331
2801,televize,22,15,7,2877,3239,3140
2802,prvne,22,11,11,2877,4527,1363
2803,mile,22,11,11,2877,4527,1363
2804,samozrejmost,22,21,1,2877,2248,20221
2805,solarnich,22,21,1,2877,2248,20221
2806,ucitel,22,8,14,2877,6340,913
2807,opakuji,22,21,1,2877,2248,20221
2808,techniku,22,20,2,2877,2376,10331
2809,pripojeni,22,19,3,2877,2518,7493
2810,nasli,22,16,6,2877,3019,4065
2811,faktu,22,16,6,2877,3019,4065
2812,bodu,22,15,7,2877,3239,3140
2813,cista,22,21,1,2877,2248,20221
2814,vcas,22,14,8,2877,3490,2491
2815,rozumej,22,9,13,2877,5608,1036
2816,svycarsko,22,20,2,2877,2376,10331
2817,jakykoliv,22,16,6,2877,3019,4065
2818,kapsy,22,13,9,2877,3784,1924
2819,novakove,22,22,0,2877,2135,49779
2820,prohlasila,22,15,7,2877,3239,3140
2821,projevu,22,19,3,2877,2518,7493
2822,ses,22,13,9,2877,3784,1924
2823,vietnamu,22,14,8,2877,3490,2491
2824,omluva,22,8,14,2877,6340,913
2825,oponovat,22,14,8,2877,3490,2491
2826,blbe,22,15,7,2877,3239,3140
2827,ucili,22,12,10,2877,4133,1614
2828,nemocnice,22,22,0,2877,2135,49779
2829,zalezelo,22,8,14,2877,6340,913
2830,duchovni,22,18,4,2877,2661,6130
2831,zaveru,22,20,2,2877,2376,10331
2832,ctyr,22,17,5,2877,2828,5101
2833,nese,22,12,10,2877,4133,1614
2834,navrat,22,14,8,2877,3490,2491
2835,jini,22,15,7,2877,3239,3140
2836,vlasy,22,8,14,2877,6340,913
2837,chyby,22,14,8,2877,3490,2491
2838,sefka,22,19,3,2877,2518,7493
2839,autora,22,17,5,2877,2828,5101
2840,mesicich,22,19,3,2877,2518,7493
2841,nasilim,22,8,14,2877,6340,913
2842,doruci,22,22,0,2877,2135,49779
2843,pokusy,22,14,8,2877,3490,2491
2844,zalobce,22,22,0,2877,2135,49779
2845,civilniho,22,22,0,2877,2135,49779
2846,jakoukoliv,22,22,0,2877,2135,49779
2847,jezdit,22,17,5,2877,2828,5101
2848,elektronicke,22,22,0,2877,2135,49779
2849,dubcek,22,13,9,2877,3784,1924
2850,nuceni,22,13,9,2877,3784,1924
2851,novymi,22,14,8,2877,3490,2491
2852,premiera,22,15,7,2877,3239,3140
2853,vedena,22,21,1,2877,2248,20221
2854,provedeni,22,19,3,2877,2518,7493
2855,nejvetsim,22,20,2,2877,2376,10331
2856,zasadne,22,14,8,2877,3490,2491
2857,desitkach,22,12,10,2877,4133,1614
2858,volit,22,5,17,2877,10167,666
2859,chapat,22,13,9,2877,3784,1924
2860,necha,22,19,3,2877,2518,7493
2861,ukazal,22,20,2,2877,2376,10331
2862,spociva,22,10,12,2877,5017,1179
2863,podzim,22,12,10,2877,4133,1614
2864,deni,22,19,3,2877,2518,7493
2865,mozek,22,16,6,2877,3019,4065
2866,nedovoli,22,20,2,2877,2376,10331
2867,sireni,22,19,3,2877,2518,7493
2868,rikate,22,21,1,2877,2248,20221
2869,lekari,22,16,6,2877,3019,4065
2870,pohode,22,16,6,2877,3019,4065
2871,bestovi,22,22,0,2877,2135,49779
2872,moznych,22,21,1,2877,2248,20221
2873,vyroku,22,16,6,2877,3019,4065
2874,gratuluju,22,22,0,2877,2135,49779
2875,sluzebni,22,14,8,2877,3490,2491
2876,krev,22,18,4,2877,2661,6130
2877,bolton,22,21,1,2877,2248,20221
2878,bere,22,12,10,2877,4133,1614
2879,zed,22,20,2,2877,2376,10331
2880,potrebne,22,20,2,2877,2376,10331
2881,tezkou,22,18,4,2877,2661,6130
2882,stranky,22,14,8,2877,3490,2491
2883,vstoupil,22,21,1,2877,2248,20221
2884,odmita,22,21,1,2877,2248,20221
2885,vzdalenost,22,19,3,2877,2518,7493
2886,nebezpecna,22,12,10,2877,4133,1614
2887,plutonia,22,22,0,2877,2135,49779
2888,eur,22,20,2,2877,2376,10331
2889,draha,22,19,3,2877,2518,7493
2890,nedava,22,17,5,2877,2828,5101
2891,nedeje,22,8,14,2877,6340,913
2892,wagner,22,19,3,2877,2518,7493
2893,pozemni,22,19,3,2877,2518,7493
2894,podpory,22,20,2,2877,2376,10331
2895,masa,22,10,12,2877,5017,1179
2896,nedojde,22,19,3,2877,2518,7493
2897,rezident,22,22,0,2877,2135,49779
2898,zdejsi,22,15,7,2877,3239,3140
2899,obsahuje,22,18,4,2877,2661,6130
2900,odborniku,22,15,7,2877,3239,3140
2901,nedokaze,22,13,9,2877,3784,1924
2902,diesely,22,22,0,2877,2135,49779
2903,uzivatele,22,15,7,2877,3239,3140
2904,odejit,22,17,5,2877,2828,5101
2905,prijatelnou,22,22,0,2877,2135,49779
2906,umyslne,22,18,4,2877,2661,6130
2907,ekologicky,22,22,0,2877,2135,49779
2908,zasahu,22,18,4,2877,2661,6130
2909,pracovniku,22,14,8,2877,3490,2491
2910,africe,22,22,0,2877,2135,49779
2911,bozi,22,14,8,2877,3490,2491
2912,chaos,22,12,10,2877,4133,1614
2913,univerzity,22,19,3,2877,2518,7493
2914,podobneho,22,18,4,2877,2661,6130
2915,ukoly,22,15,7,2877,3239,3140
2916,negativni,22,17,5,2877,2828,5101
2917,vyhrat,22,20,2,2877,2376,10331
2918,extremne,22,21,1,2877,2248,20221
2919,raketovych,22,20,2,2877,2376,10331
2920,neresi,22,18,4,2877,2661,6130
2921,precetl,22,10,12,2877,5017,1179
2922,jj,22,8,14,2877,6340,913
2923,nejakej,22,15,7,2877,3239,3140
2924,raketa,22,21,1,2877,2248,20221
2925,blabol,22,20,2,2877,2376,10331
2926,davidhavlik,22,22,0,2877,2135,49779
2927,celym,22,18,4,2877,2661,6130
2928,tresni,22,14,8,2877,3490,2491
2929,podivej,22,21,1,2877,2248,20221
2930,nazvu,22,11,11,2877,4527,1363
2931,dulezitou,22,21,1,2877,2248,20221
2932,produktu,22,15,7,2877,3239,3140
2933,mirove,22,18,4,2877,2661,6130
2934,minulym,22,14,8,2877,3490,2491
2935,duleziteho,22,22,0,2877,2135,49779
2936,vodik,22,20,2,2877,2376,10331
2937,sedi,22,12,10,2877,4133,1614
2938,jana,22,16,6,2877,3019,4065
2939,hodnoceni,22,8,14,2877,6340,913
2940,jezdi,22,20,2,2877,2376,10331
2941,zememi,22,12,10,2877,4133,1614
2942,ministerstvu,22,12,10,2877,4133,1614
2943,pokryt,22,14,8,2877,3490,2491
2944,navstevy,22,20,2,2877,2376,10331
2945,zemetreseni,22,21,1,2877,2248,20221
2946,byznys,22,22,0,2877,2135,49779
2947,rakouska,22,21,1,2877,2248,20221
2948,udalost,22,12,10,2877,4133,1614
2949,koncepci,22,20,2,2877,2376,10331
2950,trech,22,12,10,2877,4133,1614
2951,nepodari,22,20,2,2877,2376,10331
2952,hromadneho,22,20,2,2877,2376,10331
2953,vstup,22,12,10,2877,4133,1614
2954,koncepce,22,20,2,2877,2376,10331
2955,mapy,22,22,0,2877,2135,49779
2956,nemyslim,22,15,7,2877,3239,3140
2957,dostavet,21,20,1,3044,2376,20221
2958,osud,21,8,13,3044,6340,1036
2959,soucasnych,21,20,1,3044,2376,20221
2960,zasedani,21,15,6,3044,3239,4065
2961,umozni,21,18,3,3044,2661,7493
2962,ostrova,21,17,4,3044,2828,6130
2963,drahy,21,16,5,3044,3019,5101
2964,viru,21,14,7,3044,3490,3140
2965,pohrozilo,21,20,1,3044,2376,20221
2966,prinasi,21,17,4,3044,2828,6130
2967,barak,21,11,10,3044,4527,1614
2968,letiste,21,21,0,3044,2248,49779
2969,pamet,21,11,10,3044,4527,1614
2970,otec,21,12,9,3044,4133,1924
2971,jedini,21,19,2,3044,2518,10331
2972,chvile,21,13,8,3044,3784,2491
2973,vyhodne,21,16,5,3044,3019,5101
2974,naprosty,21,17,4,3044,2828,6130
2975,podporuji,21,19,2,3044,2518,10331
2976,hradu,21,11,10,3044,4527,1614
2977,vyjimky,21,9,12,3044,5608,1179
2978,vyresit,21,18,3,3044,2661,7493
2979,ostatnim,21,19,2,3044,2518,10331
2980,prokazuje,21,21,0,3044,2248,49779
2981,latek,21,16,5,3044,3019,5101
2982,panem,21,18,3,3044,2661,7493
2983,zmenil,21,12,9,3044,4133,1924
2984,jakkoliv,21,12,9,3044,4133,1924
2985,jakesi,21,12,9,3044,4133,1924
2986,vyrobene,21,18,3,3044,2661,7493
2987,prezidentovi,21,12,9,3044,4133,1924
2988,marta,21,20,1,3044,2376,20221
2989,norsku,21,16,5,3044,3019,5101
2990,dostavi,21,21,0,3044,2248,49779
2991,vittto,21,13,8,3044,3784,2491
2992,hrozne,21,16,5,3044,3019,5101
2993,vysokou,21,16,5,3044,3019,5101
2994,pakistan,21,20,1,3044,2376,20221
2995,pakistanu,21,17,4,3044,2828,6130
2996,martinczveu,21,21,0,3044,2248,49779
2997,osobnosti,21,13,8,3044,3784,2491
2998,nordstreamem,21,21,0,3044,2248,49779
2999,sorry,21,12,9,3044,4133,1924
3000,taktez,21,20,1,3044,2376,20221
3001,veleni,21,19,2,3044,2518,10331
3002,pac,21,13,8,3044,3784,2491
3003,blb,21,17,4,3044,2828,6130
3004,jednal,21,20,1,3044,2376,20221
3005,pada,21,12,9,3044,4133,1924
3006,sedmi,21,15,6,3044,3239,4065
3007,twh,21,20,1,3044,2376,20221
3008,zkusenost,21,20,1,3044,2376,20221
3009,jejiz,21,16,5,3044,3019,5101
3010,matka,21,13,8,3044,3784,2491
3011,energetickych,21,16,5,3044,3019,5101
3012,nicit,21,20,1,3044,2376,20221
3013,typy,21,18,3,3044,2661,7493
3014,parku,21,19,2,3044,2518,10331
3015,novinar,21,13,8,3044,3784,2491
3016,sousedy,21,11,10,3044,4527,1614
3017,upekli,21,7,14,3044,7246,913
3018,obchod,21,17,4,3044,2828,6130
3019,spatna,21,14,7,3044,3490,3140
3020,nebyt,21,16,5,3044,3019,5101
3021,brusel,21,20,1,3044,2376,20221
3022,nejlevnejsi,21,16,5,3044,3019,5101
3023,indii,21,20,1,3044,2376,20221
3024,vyber,21,19,2,3044,2518,10331
3025,nevidi,21,11,10,3044,4527,1614
3026,roman,21,16,5,3044,3019,5101
3027,problemem,21,19,2,3044,2518,10331
3028,snazit,21,10,11,3044,5017,1363
3029,logiky,21,16,5,3044,3019,5101
3030,kandidovat,21,15,6,3044,3239,4065
3031,nechame,21,15,6,3044,3239,4065
3032,bohate,21,16,5,3044,3019,5101
3033,plat,21,12,9,3044,4133,1924
3034,minulost,21,8,13,3044,6340,1036
3035,odtud,21,9,12,3044,5608,1179
3036,zvitezil,21,8,13,3044,6340,1036
3037,ukonceni,21,19,2,3044,2518,10331
3038,spojencu,21,21,0,3044,2248,49779
3039,bral,21,11,10,3044,4527,1614
3040,dukazem,21,13,8,3044,3784,2491
3041,tereza,21,17,4,3044,2828,6130
3042,tezka,21,19,2,3044,2518,10331
3043,sile,21,14,7,3044,3490,3140
3044,potraviny,21,18,3,3044,2661,7493
3045,detstvi,21,11,10,3044,4527,1614
3046,predstavy,21,9,12,3044,5608,1179
3047,postavil,21,18,3,3044,2661,7493
3048,reditele,21,9,12,3044,5608,1179
3049,teplo,21,13,8,3044,3784,2491
3050,srdci,21,13,8,3044,3784,2491
3051,debil,21,14,7,3044,3490,3140
3052,americanu,21,20,1,3044,2376,20221
3053,tragedie,21,9,12,3044,5608,1179
3054,zrcadlove,21,12,9,3044,4133,1924
3055,kralovstvi,21,10,11,3044,5017,1363
3056,francouzi,21,20,1,3044,2376,20221
3057,vasem,21,8,13,3044,6340,1036
3058,rumunsku,21,18,3,3044,2661,7493
3059,jmenuje,21,16,5,3044,3019,5101
3060,ameriku,21,17,4,3044,2828,6130
3061,pochybuji,21,13,8,3044,3784,2491
3062,plynovych,21,21,0,3044,2248,49779
3063,fotovoltaiky,21,17,4,3044,2828,6130
3064,rocniku,21,11,10,3044,4527,1614
3065,probihaji,21,14,7,3044,3490,3140
3066,mnohdy,21,16,5,3044,3019,5101
3067,zdravotnictvi,21,12,9,3044,4133,1924
3068,fotovoltaika,21,17,4,3044,2828,6130
3069,mire,21,17,4,3044,2828,6130
3070,necetl,21,10,11,3044,5017,1363
3071,obhajuje,21,11,10,3044,4527,1614
3072,nestane,21,17,4,3044,2828,6130
3073,zady,21,11,10,3044,4527,1614
3074,nazvem,21,16,5,3044,3019,5101
3075,zverejneny,21,13,8,3044,3784,2491
3076,nazvat,21,7,14,3044,7246,913
3077,ustavni,21,4,17,3044,12501,666
3078,dusi,21,11,10,3044,4527,1614
3079,dlouholeta,21,21,0,3044,2248,49779
3080,vydat,21,11,10,3044,4527,1614
3081,spravnym,21,15,6,3044,3239,4065
3082,obrana,21,17,4,3044,2828,6130
3083,dobrou,21,10,11,3044,5017,1363
3084,najdete,21,17,4,3044,2828,6130
3085,studium,21,11,10,3044,4527,1614
3086,blizkosti,21,18,3,3044,2661,7493
3087,privedeneho,21,21,0,3044,2248,49779
3088,rusvesnasu,21,8,13,3044,6340,1036
3089,penezi,21,13,8,3044,3784,2491
3090,pozic,21,11,10,3044,4527,1614
3091,vedcu,21,18,3,3044,2661,7493
3092,vztazich,21,13,8,3044,3784,2491
3093,dopadlo,21,13,8,3044,3784,2491
3094,udelaly,21,14,7,3044,3490,3140
3095,mezinarodnim,21,12,9,3044,4133,1924
3096,vyznamnou,21,16,5,3044,3019,5101
3097,tomahawk,21,15,6,3044,3239,4065
3098,rozdeleni,21,20,1,3044,2376,20221
3099,vedl,21,15,6,3044,3239,4065
3100,respektive,21,17,4,3044,2828,6130
3101,korejci,21,20,1,3044,2376,20221
3102,pekny,21,12,9,3044,4133,1924
3103,zvysuje,21,20,1,3044,2376,20221
3104,drzel,21,9,12,3044,5608,1179
3105,poznamenal,21,15,6,3044,3239,4065
3106,prineslo,21,15,6,3044,3239,4065
3107,nemoc,21,16,5,3044,3019,5101
3108,autobusem,21,11,10,3044,4527,1614
3109,vracet,21,7,14,3044,7246,913
3110,obavam,21,19,2,3044,2518,10331
3111,povrch,21,17,4,3044,2828,6130
3112,bloomberg,21,17,4,3044,2828,6130
3113,horke,21,11,10,3044,4527,1614
3114,svobodni,21,10,11,3044,5017,1363
3115,vyzval,21,11,10,3044,4527,1614
3116,preji,21,14,7,3044,3490,3140
3117,vychodu,21,19,2,3044,2518,10331
3118,kousek,21,15,6,3044,3239,4065
3119,prirozene,21,17,4,3044,2828,6130
3120,reky,21,15,6,3044,3239,4065
3121,realizovatelnosti,21,21,0,3044,2248,49779
3122,modulu,21,12,9,3044,4133,1924
3123,plnou,21,15,6,3044,3239,4065
3124,znamenat,21,18,3,3044,2661,7493
3125,populace,21,15,6,3044,3239,4065
3126,opakovat,21,18,3,3044,2661,7493
3127,odborne,21,20,1,3044,2376,20221
3128,varianta,21,18,3,3044,2661,7493
3129,nastoleni,21,21,0,3044,2248,49779
3130,trumpovi,21,17,4,3044,2828,6130
3131,dobreho,20,15,5,3227,3239,5101
3132,dobou,20,14,6,3227,3490,4065
3133,rikali,20,9,11,3227,5608,1363
3134,tydne,20,14,6,3227,3490,4065
3135,pouzil,20,16,4,3227,3019,6130
3136,uvidi,20,18,2,3227,2661,10331
3137,zabit,20,14,6,3227,3490,4065
3138,pouzili,20,12,8,3227,4133,2491
3139,dele,20,13,7,3227,3784,3140
3140,aktiviste,20,17,3,3227,2828,7493
3141,zustalo,20,15,5,3227,3239,5101
3142,akcionaru,20,17,3,3227,2828,7493
3143,nemysli,20,16,4,3227,3019,6130
3144,kontroly,20,18,2,3227,2661,10331
3145,vyzyva,20,11,9,3227,4527,1924
3146,beztak,20,19,1,3227,2518,20221
3147,vrazdeni,20,19,1,3227,2518,20221
3148,nechape,20,17,3,3227,2828,7493
3149,odhad,20,15,5,3227,3239,5101
3150,zisky,20,14,6,3227,3490,4065
3151,ven,20,16,4,3227,3019,6130
3152,idealni,20,15,5,3227,3239,5101
3153,hun,20,20,0,3227,2376,49779
3154,skoncilo,20,12,8,3227,4133,2491
3155,vznika,20,18,2,3227,2661,10331
3156,tohohle,20,10,10,3227,5017,1614
3157,mosty,20,12,8,3227,4133,2491
3158,masove,20,13,7,3227,3784,3140
3159,prijmout,20,11,9,3227,4527,1924
3160,ocekavat,20,19,1,3227,2518,20221
3161,skolach,20,13,7,3227,3784,3140
3162,afghanistan,20,11,9,3227,4527,1924
3163,detem,20,12,8,3227,4133,2491
3164,palivem,20,20,0,3227,2376,49779
3165,vysilani,20,17,3,3227,2828,7493
3166,evropska,20,16,4,3227,3019,6130
3167,google,20,17,3,3227,2828,7493
3168,dluhy,20,10,10,3227,5017,1614
3169,zasah,20,17,3,3227,2828,7493
3170,volne,20,18,2,3227,2661,10331
3171,povinnosti,20,11,9,3227,4527,1924
3172,evropskou,20,18,2,3227,2661,10331
3173,zverejnil,20,10,10,3227,5017,1614
3174,chape,20,17,3,3227,2828,7493
3175,titulek,20,15,5,3227,3239,5101
3176,aha,20,12,8,3227,4133,2491
3177,schvalne,20,12,8,3227,4133,2491
3178,mrtve,20,13,7,3227,3784,3140
3179,chodniky,20,8,12,3227,6340,1179
3180,maximalni,20,17,3,3227,2828,7493
3181,navrhuje,20,14,6,3227,3490,4065
3182,vystoupil,20,4,16,3227,12501,727
3183,jakoby,20,11,9,3227,4527,1924
3184,vyuziva,20,17,3,3227,2828,7493
3185,finsky,20,20,0,3227,2376,49779
3186,mysleno,20,11,9,3227,4527,1924
3187,vysec,20,20,0,3227,2376,49779
3188,firmu,20,16,4,3227,3019,6130
3189,obchodni,20,17,3,3227,2828,7493
3190,olej,20,19,1,3227,2518,20221
3191,dostanu,20,10,10,3227,5017,1614
3192,znel,20,17,3,3227,2828,7493
3193,mimoradne,20,15,5,3227,3239,5101
3194,vnitrni,20,18,2,3227,2661,10331
3195,predstava,20,13,7,3227,3784,3140
3196,poslal,20,16,4,3227,3019,6130
3197,vybrali,20,11,9,3227,4527,1924
3198,investovat,20,15,5,3227,3239,5101
3199,komise,20,14,6,3227,3490,4065
3200,poslanecke,20,16,4,3227,3019,6130
3201,zahynul,20,16,4,3227,3019,6130
3202,zakladna,20,16,4,3227,3019,6130
3203,zakladnich,20,11,9,3227,4527,1924
3204,poslou,20,15,5,3227,3239,5101
3205,cizinci,20,10,10,3227,5017,1614
3206,jadernemu,20,19,1,3227,2518,20221
3207,nemuzete,20,10,10,3227,5017,1614
3208,prvku,20,17,3,3227,2828,7493
3209,fascinujici,20,17,3,3227,2828,7493
3210,politikum,20,12,8,3227,4133,2491
3211,usili,20,19,1,3227,2518,20221
3212,cinska,20,20,0,3227,2376,49779
3213,nasledovat,20,19,1,3227,2518,20221
3214,mesici,20,18,2,3227,2661,10331
3215,slozite,20,18,2,3227,2661,10331
3216,spalovani,20,18,2,3227,2661,10331
3217,clancich,20,11,9,3227,4527,1924
3218,autokefalii,20,10,10,3227,5017,1614
3219,hlas,20,6,14,3227,8443,913
3220,autokefalie,20,12,8,3227,4133,2491
3221,pudy,20,17,3,3227,2828,7493
3222,tele,20,19,1,3227,2518,20221
3223,trumpuv,20,15,5,3227,3239,5101
3224,vytvorenych,20,20,0,3227,2376,49779
3225,cosi,20,16,4,3227,3019,6130
3226,starosti,20,12,8,3227,4133,2491
3227,latka,20,13,7,3227,3784,3140
3228,jdu,20,7,13,3227,7246,1036
3229,dodavatele,20,17,3,3227,2828,7493
3230,bacha,20,7,13,3227,7246,1036
3231,sluzba,20,9,11,3227,5608,1363
3232,miry,20,19,1,3227,2518,20221
3233,amater,20,19,1,3227,2518,20221
3234,mediich,20,13,7,3227,3784,3140
3235,takoveto,20,18,2,3227,2661,10331
3236,mist,20,18,2,3227,2661,10331
3237,prezidentu,20,20,0,3227,2376,49779
3238,rana,20,18,2,3227,2661,10331
3239,varoval,20,13,7,3227,3784,3140
3240,uprchliku,20,18,2,3227,2661,10331
3241,stabu,20,9,11,3227,5608,1363
3242,soudruhu,20,9,11,3227,5608,1363
3243,vojska,20,16,4,3227,3019,6130
3244,protiraketovy,20,17,3,3227,2828,7493
3245,mlade,20,13,7,3227,3784,3140
3246,pravni,20,12,8,3227,4133,2491
3247,fungujici,20,20,0,3227,2376,49779
3248,pravem,20,14,6,3227,3490,4065
3249,nepostavi,20,19,1,3227,2518,20221
3250,objevily,20,15,5,3227,3239,5101
3251,dostupne,20,12,8,3227,4133,2491
3252,prevazne,20,18,2,3227,2661,10331
3253,slusne,20,4,16,3227,12501,727
3254,okamzik,20,10,10,3227,5017,1614
3255,naznacuje,20,18,2,3227,2661,10331
3256,komplex,20,17,3,3227,2828,7493
3257,zahrade,20,13,7,3227,3784,3140
3258,postavena,20,12,8,3227,4133,2491
3259,dokazi,20,19,1,3227,2518,20221
3260,stara,20,11,9,3227,4527,1924
3261,vyvolat,20,19,1,3227,2518,20221
3262,vyhodu,20,17,3,3227,2828,7493
3263,spencerova,20,15,5,3227,3239,5101
3264,francouzske,20,17,3,3227,2828,7493
3265,vudce,20,13,7,3227,3784,3140
3266,inteligence,20,16,4,3227,3019,6130
3267,norska,20,16,4,3227,3019,6130
3268,komunisticke,20,16,4,3227,3019,6130
3269,trend,20,12,8,3227,4133,2491
3270,dohode,20,19,1,3227,2518,20221
3271,raketu,20,17,3,3227,2828,7493
3272,vysokych,20,11,9,3227,4527,1924
3273,ovar,20,11,9,3227,4527,1924
3274,prosince,20,18,2,3227,2661,10331
3275,vzpominam,20,12,8,3227,4133,2491
3276,elity,20,16,4,3227,3019,6130
3277,podobny,20,11,9,3227,4527,1924
3278,vetu,20,10,10,3227,5017,1614
3279,rukama,20,13,7,3227,3784,3140
3280,jeli,20,9,11,3227,5608,1363
3281,vyrobce,20,19,1,3227,2518,20221
3282,vymyslet,20,14,6,3227,3490,4065
3283,nezbytne,20,19,1,3227,2518,20221
3284,zemim,20,17,3,3227,2828,7493
3285,pochazi,20,18,2,3227,2661,10331
3286,jistotou,20,13,7,3227,3784,3140
3287,honzapalicka,20,20,0,3227,2376,49779
3288,prima,20,17,3,3227,2828,7493
3289,hodil,20,13,7,3227,3784,3140
3290,pobytu,20,14,6,3227,3490,4065
3291,katastrofe,20,17,3,3227,2828,7493
3292,uk,20,17,3,3227,2828,7493
3293,nestoji,20,18,2,3227,2661,10331
3294,svine,20,9,11,3227,5608,1363
3295,stupen,20,20,0,3227,2376,49779
3296,vesele,20,17,3,3227,2828,7493
3297,prirodnich,20,19,1,3227,2518,20221
3298,sou,20,14,6,3227,3490,4065
3299,celosvetove,20,11,9,3227,4527,1924
3300,stroju,20,17,3,3227,2828,7493
3301,prodavat,20,17,3,3227,2828,7493
3302,veskera,20,18,2,3227,2661,10331
3303,samostatne,20,13,7,3227,3784,3140
3304,manipulace,20,19,1,3227,2518,20221
3305,nahoru,20,11,9,3227,4527,1924
3306,jezdil,20,8,12,3227,6340,1179
3307,nevime,20,12,8,3227,4133,2491
3308,veskerou,20,13,7,3227,3784,3140
3309,ulici,20,10,10,3227,5017,1614
3310,prince,20,12,8,3227,4133,2491
3311,prodat,20,19,1,3227,2518,20221
3312,rusi,20,12,8,3227,4133,2491
3313,namisto,20,11,9,3227,4527,1924
3314,zavrit,20,19,1,3227,2518,20221
3315,soucasneho,20,17,3,3227,2828,7493
3316,jizda,20,9,11,3227,5608,1363
3317,cechy,20,17,3,3227,2828,7493
3318,struktury,20,19,1,3227,2518,20221
3319,snahy,20,19,1,3227,2518,20221
3320,nevis,20,10,10,3227,5017,1614
3321,zazemi,20,11,9,3227,4527,1924
3322,kroku,19,10,9,3423,5017,1924
3323,pozvani,19,16,3,3423,3019,7493
3324,beru,19,15,4,3423,3239,6130
3325,nedeli,19,16,3,3423,3019,7493
3326,fyzicky,19,11,8,3423,4527,2491
3327,zajisteni,19,17,2,3423,2828,10331
3328,diry,19,8,11,3423,6340,1363
3329,primem,19,14,5,3423,3490,5101
3330,realneho,19,10,9,3423,5017,1924
3331,zakazka,19,18,1,3423,2661,20221
3332,bludy,19,11,8,3423,4527,2491
3333,rezervy,19,18,1,3423,2661,20221
3334,postaveny,19,17,2,3423,2828,10331
3335,starat,19,16,3,3423,3019,7493
3336,nerealne,19,10,9,3423,5017,1924
3337,japonsku,19,18,1,3423,2661,20221
3338,pripojit,19,18,1,3423,2661,20221
3339,chova,19,11,8,3423,4527,2491
3340,voli,19,8,11,3423,6340,1363
3341,omezit,19,13,6,3423,3784,4065
3342,kuby,19,19,0,3423,2518,49779
3343,megazakazku,19,19,0,3423,2518,49779
3344,dulezitejsi,19,13,6,3423,3784,4065
3345,statnim,19,15,4,3423,3239,6130
3346,kosmicke,19,16,3,3423,3019,7493
3347,realna,19,11,8,3423,4527,2491
3348,obrane,19,17,2,3423,2828,10331
3349,statech,19,19,0,3423,2518,49779
3350,vzkazal,19,16,3,3423,3019,7493
3351,ukrajinskou,19,10,9,3423,5017,1924
3352,vykonnost,19,13,6,3423,3784,4065
3353,mareni,19,18,1,3423,2661,20221
3354,sluzbe,19,12,7,3423,4133,3140
3355,strankach,19,15,4,3423,3239,6130
3356,investic,19,18,1,3423,2661,20221
3357,minimum,19,14,5,3423,3490,5101
3358,sviti,19,12,7,3423,4133,3140
3359,ovzdusi,19,19,0,3423,2518,49779
3360,vraceji,19,12,7,3423,4133,3140
3361,centrum,19,14,5,3423,3490,5101
3362,radiaci,19,17,2,3423,2828,10331
3363,cz,19,14,5,3423,3490,5101
3364,povazovat,19,15,4,3423,3239,6130
3365,socialniho,19,10,9,3423,5017,1924
3366,nejvyhodnejsi,19,17,2,3423,2828,10331
3367,vb,19,13,6,3423,3784,4065
3368,utkani,19,19,0,3423,2518,49779
3369,zemedelske,19,12,7,3423,4133,3140
3370,nejvyssiho,19,11,8,3423,4527,2491
3371,narustu,19,15,4,3423,3239,6130
3372,bytu,19,17,2,3423,2828,10331
3373,narust,19,16,3,3423,3019,7493
3374,idealne,19,17,2,3423,2828,10331
3375,vyhrozovat,19,18,1,3423,2661,20221
3376,zone,19,13,6,3423,3784,4065
3377,chodili,19,6,13,3423,8443,1036
3378,vyslo,19,17,2,3423,2828,10331
3379,saudska,19,15,4,3423,3239,6130
3380,stability,19,15,4,3423,3239,6130
3381,drogy,19,8,11,3423,6340,1363
3382,vyhoreleho,19,18,1,3423,2661,20221
3383,vydela,19,10,9,3423,5017,1924
3384,kvetnu,19,19,0,3423,2518,49779
3385,prenosu,19,13,6,3423,3784,4065
3386,dmitrij,19,12,7,3423,4133,3140
3387,poli,19,18,1,3423,2661,20221
3388,hry,19,17,2,3423,2828,10331
3389,namornictva,19,9,10,3423,5608,1614
3390,izolace,19,17,2,3423,2828,10331
3391,mezivladni,19,17,2,3423,2828,10331
3392,ekologie,19,18,1,3423,2661,20221
3393,uzavreni,19,14,5,3423,3490,5101
3394,ostrave,19,9,10,3423,5608,1614
3395,opozice,19,10,9,3423,5017,1924
3396,turecka,19,13,6,3423,3784,4065
3397,rozhodli,19,10,9,3423,5017,1924
3398,likvidovat,19,15,4,3423,3239,6130
3399,premyslet,19,16,3,3423,3019,7493
3400,pracne,19,19,0,3423,2518,49779
3401,vedeli,19,15,4,3423,3239,6130
3402,plukovnik,19,8,11,3423,6340,1363
3403,balistickych,19,14,5,3423,3490,5101
3404,prvky,19,17,2,3423,2828,10331
3405,nenapadne,19,9,10,3423,5608,1614
3406,prinejmensim,19,13,6,3423,3784,4065
3407,slozek,19,9,10,3423,5608,1614
3408,novinach,19,13,6,3423,3784,4065
3409,pracovnik,19,16,3,3423,3019,7493
3410,polozil,19,15,4,3423,3239,6130
3411,vysvetluje,19,15,4,3423,3239,6130
3412,sel,19,15,4,3423,3239,6130
3413,vydiranim,19,13,6,3423,3784,4065
3414,linii,19,11,8,3423,4527,2491
3415,jadernej,19,11,8,3423,4527,2491
3416,rekli,19,15,4,3423,3239,6130
3417,povrchu,19,15,4,3423,3239,6130
3418,rozumni,19,19,0,3423,2518,49779
3419,jadru,19,17,2,3423,2828,10331
3420,prubeh,19,11,8,3423,4527,2491
3421,vydaje,19,17,2,3423,2828,10331
3422,vycviku,19,11,8,3423,4527,2491
3423,zbytku,19,18,1,3423,2661,20221
3424,uspechu,19,11,8,3423,4527,2491
3425,film,19,13,6,3423,3784,4065
3426,spojenym,19,11,8,3423,4527,2491
3427,promluvil,19,17,2,3423,2828,10331
3428,poradci,19,11,8,3423,4527,2491
3429,nesmirne,19,16,3,3423,3019,7493
3430,rezimem,19,11,8,3423,4527,2491
3431,financne,19,19,0,3423,2518,49779
3432,populaci,19,9,10,3423,5608,1614
3433,dokazat,19,11,8,3423,4527,2491
3434,klause,19,16,3,3423,3019,7493
3435,chtelo,19,13,6,3423,3784,4065
3436,obranne,19,17,2,3423,2828,10331
3437,preje,19,11,8,3423,4527,2491
3438,natlaku,19,18,1,3423,2661,20221
3439,vyhorele,19,19,0,3423,2518,49779
3440,kurz,19,14,5,3423,3490,5101
3441,casopis,19,8,11,3423,6340,1363
3442,vystoupeni,19,17,2,3423,2828,10331
3443,dostaneme,19,18,1,3423,2661,20221
3444,nahradu,19,13,6,3423,3784,4065
3445,automaticky,19,16,3,3423,3019,7493
3446,nutnosti,19,19,0,3423,2518,49779
3447,hezke,19,15,4,3423,3239,6130
3448,nosicu,19,18,1,3423,2661,20221
3449,agentura,19,14,5,3423,3490,5101
3450,cm,19,15,4,3423,3239,6130
3451,osvetleni,19,8,11,3423,6340,1363
3452,vrati,19,15,4,3423,3239,6130
3453,nastroj,19,15,4,3423,3239,6130
3454,zdravim,19,9,10,3423,5608,1614
3455,mandatu,19,12,7,3423,4133,3140
3456,jindy,19,12,7,3423,4133,3140
3457,snazil,19,9,10,3423,5608,1614
3458,nemeckou,19,12,7,3423,4133,3140
3459,stavem,19,17,2,3423,2828,10331
3460,svetla,19,12,7,3423,4133,3140
3461,mestech,19,16,3,3423,3019,7493
3462,odvetny,19,17,2,3423,2828,10331
3463,elektrickeho,19,14,5,3423,3490,5101
3464,zpusobuje,19,19,0,3423,2518,49779
3465,vanecku,19,18,1,3423,2661,20221
3466,cervene,19,12,7,3423,4133,3140
3467,pricinou,19,11,8,3423,4527,2491
3468,neb,19,18,1,3423,2661,20221
3469,hluboko,19,12,7,3423,4133,3140
3470,dovoli,19,10,9,3423,5017,1924
3471,lidskeho,19,19,0,3423,2518,49779
3472,tezsi,19,15,4,3423,3239,6130
3473,panove,19,15,4,3423,3239,6130
3474,odvete,19,18,1,3423,2661,20221
3475,vaclavmoravec,19,19,0,3423,2518,49779
3476,kapacity,19,17,2,3423,2828,10331
3477,zive,19,16,3,3423,3019,7493
3478,risi,19,9,10,3423,5608,1614
3479,kdybychom,19,14,5,3423,3490,5101
3480,kapacitu,19,16,3,3423,3019,7493
3481,vysi,19,18,1,3423,2661,20221
3482,daval,19,10,9,3423,5017,1924
3483,inteligenci,19,13,6,3423,3784,4065
3484,netreba,19,15,4,3423,3239,6130
3485,disponuje,19,18,1,3423,2661,20221
3486,paradoxne,19,16,3,3423,3019,7493
3487,nezmeni,19,18,1,3423,2661,20221
3488,bezna,19,18,1,3423,2661,20221
3489,objemu,19,13,6,3423,3784,4065
3490,narozeni,19,10,9,3423,5017,1924
3491,infrastruktura,19,19,0,3423,2518,49779
3492,aktivity,19,11,8,3423,4527,2491
3493,dejiny,19,15,4,3423,3239,6130
3494,jmena,19,11,8,3423,4527,2491
3495,bezmezne,19,9,10,3423,5608,1614
3496,prebytky,19,16,3,3423,3019,7493
3497,nikam,19,14,5,3423,3490,5101
3498,echocz,19,18,1,3423,2661,20221
3499,hmotnost,19,18,1,3423,2661,20221
3500,zastavi,19,11,8,3423,4527,2491
3501,dohodnutych,19,19,0,3423,2518,49779
3502,pouhych,19,13,6,3423,3784,4065
3503,nezna,19,11,8,3423,4527,2491
3504,lesu,19,7,12,3423,7246,1179
3505,debatu,19,9,10,3423,5608,1614
3506,and,19,18,1,3423,2661,20221
3507,padne,19,16,3,3423,3019,7493
3508,fungovalo,19,13,6,3423,3784,4065
3509,korejcum,19,19,0,3423,2518,49779
3510,konkurence,19,14,5,3423,3490,5101
3511,nechteli,19,8,11,3423,6340,1363
3512,zvysovani,19,14,5,3423,3490,5101
3513,nebezpecny,19,16,3,3423,3019,7493
3514,zbozi,19,18,1,3423,2661,20221
3515,horni,19,15,4,3423,3239,6130
3516,pozornosti,19,13,6,3423,3784,4065
3517,anexi,19,17,2,3423,2828,10331
3518,produkci,19,18,1,3423,2661,20221
3519,silene,19,18,1,3423,2661,20221
3520,dpoved,19,19,0,3423,2518,49779
3521,srovnavat,19,17,2,3423,2828,10331
3522,bydlet,19,10,9,3423,5017,1924
3523,skodu,18,13,5,3626,3784,5101
3524,klasicka,18,13,5,3626,3784,5101
3525,koule,18,14,4,3626,3490,6130
3526,finsko,18,12,6,3626,4133,4065
3527,mezinarodnich,18,16,2,3626,3019,10331
3528,nemoci,18,16,2,3626,3019,10331
3529,jednotlive,18,16,2,3626,3019,10331
3530,sklady,18,10,8,3626,5017,2491
3531,slovensko,18,16,2,3626,3019,10331
3532,policejni,18,12,6,3626,4133,4065
3533,snu,18,10,8,3626,5017,2491
3534,podporovat,18,15,3,3626,3239,7493
3535,obce,18,14,4,3626,3490,6130
3536,sva,18,12,6,3626,4133,4065
3537,nekym,18,8,10,3626,6340,1614
3538,desti,18,11,7,3626,4527,3140
3539,obsah,18,8,10,3626,6340,1614
3540,vyhlazeni,18,17,1,3626,2828,20221
3541,scenare,18,13,5,3626,3784,5101
3542,uvahu,18,17,1,3626,2828,20221
3543,normy,18,16,2,3626,3019,10331
3544,kvoty,18,11,7,3626,4527,3140
3545,zisku,18,15,3,3626,3239,7493
3546,valcit,18,16,2,3626,3019,10331
3547,zbyvajici,18,9,9,3626,5608,1924
3548,blbec,18,7,11,3626,7246,1363
3549,zdokonalovanych,18,18,0,3626,2661,49779
3550,posadky,18,13,5,3626,3784,5101
3551,soci,18,8,10,3626,6340,1614
3552,omlouvam,18,12,6,3626,4133,4065
3553,iq,18,13,5,3626,3784,5101
3554,nasledek,18,17,1,3626,2828,20221
3555,nejbohatsi,18,10,8,3626,5017,2491
3556,firme,18,17,1,3626,2828,20221
3557,yorku,18,16,2,3626,3019,10331
3558,jednotlivce,18,9,9,3626,5608,1924
3559,soucast,18,18,0,3626,2661,49779
3560,firmam,18,12,6,3626,4133,4065
3561,vytrvale,18,10,8,3626,5017,2491
3562,hrozbe,18,13,5,3626,3784,5101
3563,vezme,18,14,4,3626,3490,6130
3564,poledne,18,8,10,3626,6340,1614
3565,presvedcit,18,9,9,3626,5608,1924
3566,sluncem,18,9,9,3626,5608,1924
3567,britsky,18,17,1,3626,2828,20221
3568,prubehu,18,15,3,3626,3239,7493
3569,narozdil,18,14,4,3626,3490,6130
3570,klicove,18,17,1,3626,2828,20221
3571,nakup,18,16,2,3626,3019,10331
3572,dopadu,18,14,4,3626,3490,6130
3573,prachu,18,18,0,3626,2661,49779
3574,sesti,18,18,0,3626,2661,49779
3575,respektovat,18,11,7,3626,4527,3140
3576,koalice,18,8,10,3626,6340,1614
3577,rozhoduje,18,14,4,3626,3490,6130
3578,kdesi,18,13,5,3626,3784,5101
3579,dopadl,18,5,13,3626,10167,1036
3580,zrusila,18,4,14,3626,12501,913
3581,neukoluje,18,18,0,3626,2661,49779
3582,evidentni,18,11,7,3626,4527,3140
3583,odstranit,18,10,8,3626,5017,2491
3584,hlouposti,18,7,11,3626,7246,1363
3585,dneskem,18,10,8,3626,5017,2491
3586,doopravdy,18,16,2,3626,3019,10331
3587,mil,18,18,0,3626,2661,49779
3588,napadne,18,12,6,3626,4133,4065
3589,mixu,18,18,0,3626,2661,49779
3590,obama,18,17,1,3626,2828,20221
3591,pameti,18,13,5,3626,3784,5101
3592,jednotek,18,17,1,3626,2828,20221
3593,potravin,18,16,2,3626,3019,10331
3594,umime,18,15,3,3626,3239,7493
3595,pusobi,18,16,2,3626,3019,10331
3596,slusi,18,3,15,3626,16064,809
3597,systemem,18,14,4,3626,3490,6130
3598,nabidnout,18,8,10,3626,6340,1614
3599,vyrabely,18,15,3,3626,3239,7493
3600,televizni,18,17,1,3626,2828,20221
3601,ucet,18,16,2,3626,3019,10331
3602,iranem,18,18,0,3626,2661,49779
3603,soucasnost,18,10,8,3626,5017,2491
3604,zacinam,18,9,9,3626,5608,1924
3605,zenevskych,18,18,0,3626,2661,49779
3606,trumpem,18,17,1,3626,2828,20221
3607,vsimat,18,12,6,3626,4133,4065
3608,priste,18,13,5,3626,3784,5101
3609,utrpeni,18,11,7,3626,4527,3140
3610,obcana,18,10,8,3626,5017,2491
3611,iransky,18,18,0,3626,2661,49779
3612,katastrofu,18,15,3,3626,3239,7493
3613,zlociny,18,10,8,3626,5017,2491
3614,snizuje,18,15,3,3626,3239,7493
3615,plynem,18,13,5,3626,3784,5101
3616,hotovo,18,16,2,3626,3019,10331
3617,pravdy,18,9,9,3626,5608,1924
3618,provozni,18,17,1,3626,2828,20221
3619,osudu,18,12,6,3626,4133,4065
3620,hodit,18,9,9,3626,5608,1924
3621,mneli,18,18,0,3626,2661,49779
3622,kubera,18,1,17,3626,43884,666
3623,navzajem,18,7,11,3626,7246,1363
3624,benzinu,18,14,4,3626,3490,6130
3625,pousti,18,10,8,3626,5017,2491
3626,zvitezit,18,17,1,3626,2828,20221
3627,spolecnou,18,14,4,3626,3490,6130
3628,sluzbu,18,16,2,3626,3019,10331
3629,problemech,18,17,1,3626,2828,20221
3630,poslusne,18,2,16,3626,22971,727
3631,revoluci,18,15,3,3626,3239,7493
3632,davam,18,14,4,3626,3490,6130
3633,sebemensi,18,7,11,3626,7246,1363
3634,ozbrojenych,18,16,2,3626,3019,10331
3635,spravy,18,18,0,3626,2661,49779
3636,zabery,18,9,9,3626,5608,1924
3637,kampan,18,12,6,3626,4133,4065
3638,saudum,18,14,4,3626,3490,6130
3639,nejspise,18,14,4,3626,3490,6130
3640,hovado,18,4,14,3626,12501,913
3641,modely,18,15,3,3626,3239,7493
3642,vyvinout,18,13,5,3626,3784,5101
3643,posledniho,18,15,3,3626,3239,7493
3644,jasnym,18,10,8,3626,5017,2491
3645,opustit,18,14,4,3626,3490,6130
3646,necekal,18,10,8,3626,5017,2491
3647,ocima,18,10,8,3626,5017,2491
3648,obvinil,18,8,10,3626,6340,1614
3649,neefektivni,18,17,1,3626,2828,20221
3650,obdobne,18,15,3,3626,3239,7493
3651,chlapi,18,9,9,3626,5608,1924
3652,cechu,18,17,1,3626,2828,20221
3653,marsu,18,18,0,3626,2661,49779
3654,uznavam,18,8,10,3626,6340,1614
3655,fosilnich,18,17,1,3626,2828,20221
3656,utocne,18,14,4,3626,3490,6130
3657,ochrana,18,16,2,3626,3019,10331
3658,strategie,18,16,2,3626,3019,10331
3659,zjistil,18,13,5,3626,3784,5101
3660,forum,18,17,1,3626,2828,20221
3661,zdanlive,18,10,8,3626,5017,2491
3662,snizovani,18,15,3,3626,3239,7493
3663,bridil,18,12,6,3626,4133,4065
3664,druhym,18,13,5,3626,3784,5101
3665,namesti,18,10,8,3626,5017,2491
3666,zpracovani,18,16,2,3626,3019,10331
3667,energeticky,18,15,3,3626,3239,7493
3668,pobliz,18,16,2,3626,3019,10331
3669,vize,18,17,1,3626,2828,20221
3670,jazyk,18,9,9,3626,5608,1924
3671,zpravu,18,15,3,3626,3239,7493
3672,httpechocz,18,17,1,3626,2828,20221
3673,vodnich,18,16,2,3626,3019,10331
3674,prikladem,18,17,1,3626,2828,20221
3675,kazdym,18,17,1,3626,2828,20221
3676,pripraveny,18,8,10,3626,6340,1614
3677,novinky,18,17,1,3626,2828,20221
3678,rozsah,18,10,8,3626,5017,2491
3679,fuj,18,10,8,3626,5017,2491
3680,ohrozila,18,18,0,3626,2661,49779
3681,zareagoval,18,8,10,3626,6340,1614
3682,prinesl,18,4,14,3626,12501,913
3683,silnici,18,7,11,3626,7246,1363
3684,investori,18,14,4,3626,3490,6130
3685,zadnych,18,16,2,3626,3019,10331
3686,potvrzuje,18,14,4,3626,3490,6130
3687,pomer,18,14,4,3626,3490,6130
3688,prispevky,18,12,6,3626,4133,4065
3689,mozku,18,14,4,3626,3490,6130
3690,takovi,18,12,6,3626,4133,4065
3691,neumite,18,3,15,3626,16064,809
3692,citace,18,9,9,3626,5608,1924
3693,vrsr,18,10,8,3626,5017,2491
3694,afriky,18,12,6,3626,4133,4065
3695,zajimat,18,7,11,3626,7246,1363
3696,vnitra,18,15,3,3626,3239,7493
3697,navrhuji,18,15,3,3626,3239,7493
3698,prezidentske,18,9,9,3626,5608,1924
3699,organizmu,18,18,0,3626,2661,49779
3700,chodil,18,6,12,3626,8443,1179
3701,dejin,18,10,8,3626,5017,2491
3702,projit,18,7,11,3626,7246,1363
3703,citil,18,3,15,3626,16064,809
3704,nocni,18,14,4,3626,3490,6130
3705,umluvach,18,18,0,3626,2661,49779
3706,vraha,18,12,6,3626,4133,4065
3707,vedoucich,18,6,12,3626,8443,1179
3708,cenove,18,16,2,3626,3019,10331
3709,sirit,18,17,1,3626,2828,20221
3710,vlakem,18,7,11,3626,7246,1363
3711,mirne,18,17,1,3626,2828,20221
3712,princ,18,8,10,3626,6340,1614
3713,pytel,18,4,14,3626,12501,913
3714,nepochopil,18,11,7,3626,4527,3140
3715,zazil,18,8,10,3626,6340,1614
3716,touha,18,10,8,3626,5017,2491
3717,dotaz,18,14,4,3626,3490,6130
3718,zpusobili,18,11,7,3626,4527,3140
3719,zbytecna,18,7,11,3626,7246,1363
3720,poslali,18,12,6,3626,4133,4065
3721,podezreni,18,11,7,3626,4527,3140
3722,brani,18,16,2,3626,3019,10331
3723,hromadne,18,15,3,3626,3239,7493
3724,nadeje,18,8,10,3626,6340,1614
3725,kasy,18,11,7,3626,4527,3140
3726,tvrdim,18,12,6,3626,4133,4065
3727,pvo,18,15,3,3626,3239,7493
3728,procento,17,6,11,3869,8443,1363
3729,cirkev,17,10,7,3869,5017,3140
3730,vlastniho,17,16,1,3869,3019,20221
3731,pracuji,17,15,2,3869,3239,10331
3732,dodavaji,17,16,1,3869,3019,20221
3733,spojence,17,17,0,3869,2828,49779
3734,destnik,17,11,6,3869,4527,4065
3735,slovensku,17,15,2,3869,3239,10331
3736,vyraz,17,9,8,3869,5608,2491
3737,kluk,17,3,14,3869,16064,913
3738,kw,17,16,1,3869,3019,20221
3739,vydal,17,12,5,3869,4133,5101
3740,pomuze,17,11,6,3869,4527,4065
3741,zenu,17,10,7,3869,5017,3140
3742,odlisne,17,12,5,3869,4133,5101
3743,dlouhy,17,12,5,3869,4133,5101
3744,vydavali,17,5,12,3869,10167,1179
3745,riziku,17,10,7,3869,5017,3140
3746,neboli,17,16,1,3869,3019,20221
3747,psala,17,12,5,3869,4133,5101
3748,pravy,17,13,4,3869,3784,6130
3749,informovala,17,15,2,3869,3239,10331
3750,technika,17,13,4,3869,3784,6130
3751,zrusili,17,13,4,3869,3784,6130
3752,nemusel,17,12,5,3869,4133,5101
3753,nemuzu,17,9,8,3869,5608,2491
3754,potvrdil,17,10,7,3869,5017,3140
3755,dejme,17,6,11,3869,8443,1363
3756,vyraznou,17,8,9,3869,6340,1924
3757,kniha,17,10,7,3869,5017,3140
3758,agenti,17,14,3,3869,3490,7493
3759,uzemni,17,12,5,3869,4133,5101
3760,nemohlo,17,15,2,3869,3239,10331
3761,zavadeni,17,13,4,3869,3784,6130
3762,prazaci,17,2,15,3869,22971,809
3763,rozvedka,17,12,5,3869,4133,5101
3764,reagan,17,16,1,3869,3019,20221
3765,ukladani,17,15,2,3869,3239,10331
3766,ztrata,17,12,5,3869,4133,5101
3767,konferenci,17,15,2,3869,3239,10331
3768,presidenta,17,7,10,3869,7246,1614
3769,potvoru,17,9,8,3869,5608,2491
3770,logika,17,15,2,3869,3239,10331
3771,neskutecne,17,8,9,3869,6340,1924
3772,cdu,17,17,0,3869,2828,49779
3773,slabe,17,12,5,3869,4133,5101
3774,povinne,17,13,4,3869,3784,6130
3775,navsteve,17,7,10,3869,7246,1614
3776,majetek,17,8,9,3869,6340,1924
3777,hospodarske,17,15,2,3869,3239,10331
3778,mym,17,11,6,3869,4527,4065
3779,tisk,17,8,9,3869,6340,1924
3780,predsedkyni,17,17,0,3869,2828,49779
3781,moznym,17,8,9,3869,6340,1924
3782,delnik,17,10,7,3869,5017,3140
3783,nesnasim,17,9,8,3869,5608,2491
3784,kritizoval,17,13,4,3869,3784,6130
3785,pouzivani,17,15,2,3869,3239,10331
3786,mmf,17,9,8,3869,5608,2491
3787,bombardovat,17,15,2,3869,3239,10331
3788,fotr,17,7,10,3869,7246,1614
3789,magor,17,16,1,3869,3019,20221
3790,svoboda,17,14,3,3869,3490,7493
3791,delnici,17,10,7,3869,5017,3140
3792,ucinnosti,17,17,0,3869,2828,49779
3793,miluji,17,9,8,3869,5608,2491
3794,navratu,17,15,2,3869,3239,10331
3795,obchody,17,12,5,3869,4133,5101
3796,dcery,17,8,9,3869,6340,1924
3797,vymysli,17,14,3,3869,3490,7493
3798,incidentu,17,16,1,3869,3019,20221
3799,hodla,17,9,8,3869,5608,2491
3800,nekolikanasobne,17,17,0,3869,2828,49779
3801,nevyhnutelna,17,12,5,3869,4133,5101
3802,poust,17,13,4,3869,3784,6130
3803,poslat,17,12,5,3869,4133,5101
3804,nejste,17,13,4,3869,3784,6130
3805,vtip,17,11,6,3869,4527,4065
3806,vuli,17,15,2,3869,3239,10331
3807,minulou,17,8,9,3869,6340,1924
3808,budouciho,17,8,9,3869,6340,1924
3809,bytost,17,10,7,3869,5017,3140
3810,vyvolava,17,17,0,3869,2828,49779
3811,nevylucuje,17,7,10,3869,7246,1614
3812,elektrine,17,14,3,3869,3490,7493
3813,postaveni,17,11,6,3869,4527,4065
3814,realnem,17,7,10,3869,7246,1614
3815,volbam,17,7,10,3869,7246,1614
3816,radove,17,15,2,3869,3239,10331
3817,ukrajinskym,17,10,7,3869,5017,3140
3818,nejmensim,17,9,8,3869,5608,2491
3819,vyberoveho,17,14,3,3869,3490,7493
3820,fyzicke,17,12,5,3869,4133,5101
3821,interview,17,11,6,3869,4527,4065
3822,vver,17,17,0,3869,2828,49779
3823,krasnodarskem,17,7,10,3869,7246,1614
3824,trhy,17,16,1,3869,3019,20221
3825,libilo,17,8,9,3869,6340,1924
3826,splnil,17,10,7,3869,5017,3140
3827,realizaci,17,17,0,3869,2828,49779
3828,dobrej,17,10,7,3869,5017,3140
3829,holky,17,7,10,3869,7246,1614
3830,nejsilnejsi,17,14,3,3869,3490,7493
3831,pripravena,17,16,1,3869,3019,20221
3832,for,17,15,2,3869,3239,10331
3833,predpoklada,17,14,3,3869,3490,7493
3834,teplota,17,14,3,3869,3490,7493
3835,zajmum,17,14,3,3869,3490,7493
3836,kone,17,6,11,3869,8443,1363
3837,dusledek,17,16,1,3869,3019,20221
3838,trpet,17,12,5,3869,4133,5101
3839,nedostane,17,12,5,3869,4133,5101
3840,povedou,17,6,11,3869,8443,1363
3841,rovna,17,14,3,3869,3490,7493
3842,rocnik,17,9,8,3869,5608,2491
3843,john,17,16,1,3869,3019,20221
3844,zverejneno,17,10,7,3869,5017,3140
3845,bunkr,17,16,1,3869,3019,20221
3846,atomova,17,17,0,3869,2828,49779
3847,dnesku,17,17,0,3869,2828,49779
3848,rapidne,17,10,7,3869,5017,3140
3849,pravice,17,9,8,3869,5608,2491
3850,bolesti,17,10,7,3869,5017,3140
3851,sranda,17,16,1,3869,3019,20221
3852,cokoli,17,16,1,3869,3019,20221
3853,plutonium,17,16,1,3869,3019,20221
3854,zachranit,17,15,2,3869,3239,10331
3855,nezajima,17,12,5,3869,4133,5101
3856,mistnich,17,15,2,3869,3239,10331
3857,emigraci,17,3,14,3869,16064,913
3858,kontrolu,17,15,2,3869,3239,10331
3859,mobilni,17,14,3,3869,3490,7493
3860,kvalitniho,17,11,6,3869,4527,4065
3861,mali,17,11,6,3869,4527,4065
3862,clenem,17,15,2,3869,3239,10331
3863,clena,17,6,11,3869,8443,1363
3864,akumulace,17,12,5,3869,4133,5101
3865,online,17,15,2,3869,3239,10331
3866,ucinili,17,7,10,3869,7246,1614
3867,argumentu,17,15,2,3869,3239,10331
3868,elektrarnam,17,17,0,3869,2828,49779
3869,volat,17,4,13,3869,12501,1036
3870,havel,17,9,8,3869,5608,2491
3871,kontinentu,17,15,2,3869,3239,10331
3872,vnejsi,17,15,2,3869,3239,10331
3873,stupne,17,16,1,3869,3019,20221
3874,sis,17,10,7,3869,5017,3140
3875,vyuzivani,17,12,5,3869,4133,5101
3876,omylem,17,14,3,3869,3490,7493
3877,sli,17,11,6,3869,4527,4065
3878,rijadu,17,12,5,3869,4133,5101
3879,finsku,17,15,2,3869,3239,10331
3880,kolo,17,8,9,3869,6340,1924
3881,vyuzivaji,17,11,6,3869,4527,4065
3882,pesky,17,9,8,3869,5608,2491
3883,vypukne,17,13,4,3869,3784,6130
3884,pisku,17,8,9,3869,6340,1924
3885,vychodniho,17,10,7,3869,5017,3140
3886,pristavu,17,12,5,3869,4133,5101
3887,netusim,17,13,4,3869,3784,6130
3888,ducha,17,11,6,3869,4527,4065
3889,vyzaduje,17,16,1,3869,3019,20221
3890,zaklad,17,12,5,3869,4133,5101
3891,iranske,17,17,0,3869,2828,49779
3892,elektrarnami,17,17,0,3869,2828,49779
3893,kole,17,7,10,3869,7246,1614
3894,pusti,17,6,11,3869,8443,1363
3895,podari,17,12,5,3869,4133,5101
3896,predstavoval,17,7,10,3869,7246,1614
3897,duchodu,17,10,7,3869,5017,3140
3898,boze,17,8,9,3869,6340,1924
3899,presvedceni,17,12,5,3869,4133,5101
3900,platil,17,5,12,3869,10167,1179
3901,jdete,17,6,11,3869,8443,1363
3902,lisi,17,14,3,3869,3490,7493
3903,doufejme,17,12,5,3869,4133,5101
3904,lehce,17,12,5,3869,4133,5101
3905,vykonem,17,15,2,3869,3239,10331
3906,podniknou,17,17,0,3869,2828,49779
3907,jenz,17,17,0,3869,2828,49779
3908,primarne,17,14,3,3869,3490,7493
3909,nkvd,17,9,8,3869,5608,2491
3910,vystoupit,17,4,13,3869,12501,1036
3911,zlocince,17,4,13,3869,12501,1036
3912,ozbrojenci,17,12,5,3869,4133,5101
3913,jasno,17,13,4,3869,3784,6130
3914,koupil,17,13,4,3869,3784,6130
3915,management,17,12,5,3869,4133,5101
3916,cia,17,15,2,3869,3239,10331
3917,lito,17,10,7,3869,5017,3140
3918,nadrazi,17,14,3,3869,3490,7493
3919,bilym,17,8,9,3869,6340,1924
3920,jednodussi,17,17,0,3869,2828,49779
3921,sotva,17,15,2,3869,3239,10331
3922,smeruje,17,15,2,3869,3239,10331
3923,vaclav,17,13,4,3869,3784,6130
3924,policiste,17,12,5,3869,4133,5101
3925,evropsti,17,8,9,3869,6340,1924
3926,korunni,17,10,7,3869,5017,3140
3927,zjednodusene,17,14,3,3869,3490,7493
3928,tymu,17,8,9,3869,6340,1924
3929,naprostou,17,14,3,3869,3490,7493
3930,korupce,17,11,6,3869,4527,4065
3931,rozsahle,17,11,6,3869,4527,4065
3932,hovori,17,16,1,3869,3019,20221
3933,cerneho,17,12,5,3869,4133,5101
3934,vznikly,17,16,1,3869,3019,20221
3935,sefuje,17,15,2,3869,3239,10331
3936,syna,17,8,9,3869,6340,1924
3937,podruci,17,17,0,3869,2828,49779
3938,obsahu,17,14,3,3869,3490,7493
3939,chranit,17,16,1,3869,3019,20221
3940,facto,17,12,5,3869,4133,5101
3941,manevry,17,16,1,3869,3019,20221
3942,nerikam,17,12,5,3869,4133,5101
3943,svedsko,17,12,5,3869,4133,5101
3944,spotrebuje,17,16,1,3869,3019,20221
3945,vina,17,6,11,3869,8443,1363
3946,umirat,17,8,9,3869,6340,1924
3947,mensich,17,14,3,3869,3490,7493
3948,vyrobi,17,17,0,3869,2828,49779
3949,verejnost,17,14,3,3869,3490,7493
3950,nepamatuji,17,7,10,3869,7246,1614
3951,drony,17,12,5,3869,4133,5101
3952,stromy,17,8,9,3869,6340,1924
3953,pozadavku,17,16,1,3869,3019,20221
3954,sedet,17,11,6,3869,4527,4065
3955,soukrome,17,14,3,3869,3490,7493
3956,odchodu,17,9,8,3869,5608,2491
3957,saudove,17,12,5,3869,4133,5101
3958,globalnim,17,15,2,3869,3239,10331
3959,eet,17,7,10,3869,7246,1614
3960,zlikvidovan,17,4,13,3869,12501,1036
3961,hlavnich,17,16,1,3869,3019,20221
3962,zli,17,12,5,3869,4133,5101
3963,sefem,17,8,9,3869,6340,1924
3964,mandat,17,8,9,3869,6340,1924
3965,ovce,17,7,10,3869,7246,1614
3966,zvolili,17,11,6,3869,4527,4065
3967,plnit,17,14,3,3869,3490,7493
3968,japonsko,17,16,1,3869,3019,20221
3969,japonska,17,17,0,3869,2828,49779
3970,bavorsku,17,14,3,3869,3490,7493
3971,neplneni,17,10,7,3869,5017,3140
3972,prevratu,17,14,3,3869,3490,7493
3973,nezbyva,17,14,3,3869,3490,7493
3974,vezmu,17,10,7,3869,5017,3140
3975,primou,17,11,6,3869,4527,4065
3976,politickymi,17,10,7,3869,5017,3140
3977,jidlo,17,14,3,3869,3490,7493
3978,zili,17,12,5,3869,4133,5101
3979,pruzkum,17,14,3,3869,3490,7493
3980,prijel,17,16,1,3869,3019,20221
3981,novinaru,17,8,9,3869,6340,1924
3982,panelaky,17,9,8,3869,5608,2491
3983,zautoci,17,17,0,3869,2828,49779
3984,politikou,17,13,4,3869,3784,6130
3985,umyslu,17,7,10,3869,7246,1614
3986,zdi,17,10,7,3869,5017,3140
3987,neprisel,17,7,10,3869,7246,1614
3988,jedy,17,15,2,3869,3239,10331
3989,koreji,17,13,4,3869,3784,6130
3990,zima,17,13,4,3869,3784,6130
3991,ceskoslovenska,17,15,2,3869,3239,10331
3992,vitezi,17,7,10,3869,7246,1614
3993,drahos,17,3,14,3869,16064,913
3994,zdalo,17,7,10,3869,7246,1614
3995,nevadilo,17,9,8,3869,5608,2491
3996,ruznymi,17,16,1,3869,3019,20221
3997,podobnou,17,15,2,3869,3239,10331
3998,podobnym,17,7,10,3869,7246,1614
3999,tzn,17,16,1,3869,3019,20221
4000,cgn,17,17,0,3869,2828,49779
4001,sen,17,13,4,3869,3784,6130
4002,drabovou,17,14,3,3869,3490,7493
4003,zaminka,17,11,6,3869,4527,4065
4004,nenavidi,17,10,7,3869,5017,3140
4005,jednotlivym,17,11,6,3869,4527,4065
4006,prestali,17,15,2,3869,3239,10331
4007,prusvih,17,15,2,3869,3239,10331
4008,snizi,17,16,1,3869,3019,20221
4009,spolehat,17,13,4,3869,3784,6130
4010,odstoupit,16,5,11,4162,10167,1363
4011,demonstraci,16,10,6,4162,5017,4065
4012,str,16,16,0,4162,3019,49779
4013,sobotu,16,14,2,4162,3490,10331
4014,kazdej,16,12,4,4162,4133,6130
4015,recko,16,16,0,4162,3019,49779
4016,statecne,16,11,5,4162,4527,5101
4017,ztrati,16,15,1,4162,3239,20221
4018,miluje,16,6,10,4162,8443,1614
4019,jest,16,7,9,4162,7246,1924
4020,generalove,16,16,0,4162,3019,49779
4021,kseft,16,12,4,4162,4133,6130
4022,nebudete,16,10,6,4162,5017,4065
4023,doktrinu,16,15,1,4162,3239,20221
4024,okraj,16,12,4,4162,4133,6130
4025,ocitli,16,8,8,4162,6340,2491
4026,poslani,16,10,6,4162,5017,4065
4027,necekane,16,7,9,4162,7246,1924
4028,kral,16,5,11,4162,10167,1363
4029,nocnim,16,2,14,4162,22971,913
4030,hledaji,16,16,0,4162,3019,49779
4031,vyboru,16,14,2,4162,3490,10331
4032,vrstvy,16,4,12,4162,12501,1179
4033,pritomnosti,16,13,3,4162,3784,7493
4034,startu,16,12,4,4162,4133,6130
4035,vylozene,16,9,7,4162,5608,3140
4036,explozi,16,14,2,4162,3490,10331
4037,hledacku,16,8,8,4162,6340,2491
4038,soudy,16,7,9,4162,7246,1924
4039,vraci,16,8,8,4162,6340,2491
4040,jaroslav,16,15,1,4162,3239,20221
4041,predstavuji,16,15,1,4162,3239,20221
4042,dukazu,16,15,1,4162,3239,20221
4043,spokojen,16,4,12,4162,12501,1179
4044,jaro,16,9,7,4162,5608,3140
4045,pamatujete,16,10,6,4162,5017,4065
4046,predstaviteli,16,14,2,4162,3490,10331
4047,zbranim,16,15,1,4162,3239,20221
4048,myslenka,16,15,1,4162,3239,20221
4049,kdezto,16,15,1,4162,3239,20221
4050,vyssich,16,15,1,4162,3239,20221
4051,rychlost,16,16,0,4162,3019,49779
4052,troll,16,3,13,4162,16064,1036
4053,zs,16,6,10,4162,8443,1614
4054,hrozbu,16,12,4,4162,4133,6130
4055,ceskem,16,12,4,4162,4133,6130
4056,zkusil,16,6,10,4162,8443,1614
4057,svazem,16,13,3,4162,3784,7493
4058,vypadat,16,12,4,4162,4133,6130
4059,zvedavy,16,13,3,4162,3784,7493
4060,asie,16,12,4,4162,4133,6130
4061,ziskavani,16,14,2,4162,3490,10331
4062,provokace,16,14,2,4162,3490,10331
4063,nehody,16,8,8,4162,6340,2491
4064,cervna,16,16,0,4162,3019,49779
4065,temelinu,16,15,1,4162,3239,20221
4066,vyuzije,16,3,13,4162,16064,1036
4067,domacnosti,16,13,3,4162,3784,7493
4068,mnohym,16,6,10,4162,8443,1614
4069,pozadavky,16,15,1,4162,3239,20221
4070,koukam,16,10,6,4162,5017,4065
4071,zkus,16,13,3,4162,3784,7493
4072,ussa,16,15,1,4162,3239,20221
4073,rozvoje,16,15,1,4162,3239,20221
4074,ocekava,16,15,1,4162,3239,20221
4075,zajistil,16,9,7,4162,5608,3140
4076,omezene,16,14,2,4162,3490,10331
4077,provadet,16,15,1,4162,3239,20221
4078,kombinace,16,13,3,4162,3784,7493
4079,smichy,16,7,9,4162,7246,1924
4080,spotrebe,16,13,3,4162,3784,7493
4081,radikalni,16,14,2,4162,3490,10331
4082,vyjimkou,16,15,1,4162,3239,20221
4083,st,16,16,0,4162,3019,49779
4084,doletem,16,14,2,4162,3490,10331
4085,ceskoslovensko,16,14,2,4162,3490,10331
4086,kolony,16,7,9,4162,7246,1924
4087,zatahl,16,8,8,4162,6340,2491
4088,prohlasenim,16,13,3,4162,3784,7493
4089,vetsich,16,10,6,4162,5017,4065
4090,ekonomicka,16,14,2,4162,3490,10331
4091,vyplati,16,15,1,4162,3239,20221
4092,duvodem,16,14,2,4162,3490,10331
4093,ztraci,16,8,8,4162,6340,2491
4094,upozornil,16,10,6,4162,5017,4065
4095,veliky,16,12,4,4162,4133,6130
4096,investicni,16,15,1,4162,3239,20221
4097,vymenou,16,16,0,4162,3019,49779
4098,listu,16,12,4,4162,4133,6130
4099,zacinal,16,8,8,4162,6340,2491
4100,fotky,16,8,8,4162,6340,2491
4101,bezpeci,16,14,2,4162,3490,10331
4102,jelo,16,8,8,4162,6340,2491
4103,sibir,16,13,3,4162,3784,7493
4104,postupu,16,14,2,4162,3490,10331
4105,pocitace,16,13,3,4162,3784,7493
4106,neberu,16,8,8,4162,6340,2491
4107,skvela,16,6,10,4162,8443,1614
4108,nestesti,16,12,4,4162,4133,6130
4109,vyjadrit,16,7,9,4162,7246,1924
4110,parizi,16,12,4,4162,4133,6130
4111,andrejbabis,16,16,0,4162,3019,49779
4112,propojeni,16,15,1,4162,3239,20221
4113,minuty,16,14,2,4162,3490,10331
4114,hraji,16,14,2,4162,3490,10331
4115,ochoten,16,8,8,4162,6340,2491
4116,nepovedla,16,10,6,4162,5017,4065
4117,slysite,16,10,6,4162,5017,4065
4118,nepsal,16,6,10,4162,8443,1614
4119,bily,16,12,4,4162,4133,6130
4120,ohne,16,16,0,4162,3019,49779
4121,nevsimnout,16,15,1,4162,3239,20221
4122,zpusobu,16,15,1,4162,3239,20221
4123,spokojeni,16,8,8,4162,6340,2491
4124,jednicku,16,9,7,4162,5608,3140
4125,vyplacet,16,10,6,4162,5017,4065
4126,debaty,16,14,2,4162,3490,10331
4127,zasahnout,16,14,2,4162,3490,10331
4128,bojuji,16,11,5,4162,4527,5101
4129,placeni,16,12,4,4162,4133,6130
4130,dobytek,16,12,4,4162,4133,6130
4131,zada,16,15,1,4162,3239,20221
4132,brehu,16,13,3,4162,3784,7493
4133,dohod,16,12,4,4162,4133,6130
4134,su,16,13,3,4162,3784,7493
4135,poznat,16,11,5,4162,4527,5101
4136,miroslav,16,15,1,4162,3239,20221
4137,stylu,16,14,2,4162,3490,10331
4138,integrace,16,12,4,4162,4133,6130
4139,rodine,16,10,6,4162,5017,4065
4140,krat,16,16,0,4162,3019,49779
4141,objevili,16,15,1,4162,3239,20221
4142,podstatny,16,4,12,4162,12501,1179
4143,zradlo,16,8,8,4162,6340,2491
4144,skupinu,16,15,1,4162,3239,20221
4145,venovat,16,14,2,4162,3490,10331
4146,udaju,16,14,2,4162,3490,10331
4147,stretu,16,15,1,4162,3239,20221
4148,radosti,16,9,7,4162,5608,3140
4149,pil,16,5,11,4162,10167,1363
4150,zastavaji,16,10,6,4162,5017,4065
4151,marne,16,12,4,4162,4133,6130
4152,maj,16,11,5,4162,4527,5101
4153,vymysleli,16,14,2,4162,3490,10331
4154,bohatych,16,12,4,4162,4133,6130
4155,vazeni,16,10,6,4162,5017,4065
4156,skodi,16,8,8,4162,6340,2491
4157,pratel,16,8,8,4162,6340,2491
4158,zide,16,16,0,4162,3019,49779
4159,plni,16,13,3,4162,3784,7493
4160,nahoda,16,7,9,4162,7246,1924
4161,ad,16,15,1,4162,3239,20221
4162,nedari,16,14,2,4162,3490,10331
4163,okamura,16,9,7,4162,5608,3140
4164,koncil,16,8,8,4162,6340,2491
4165,invaze,16,10,6,4162,5017,4065
4166,uc,16,8,8,4162,6340,2491
4167,elektromobil,16,14,2,4162,3490,10331
4168,schopnych,16,12,4,4162,4133,6130
4169,frazi,16,7,9,4162,7246,1924
4170,srovnat,16,10,6,4162,5017,4065
4171,lubomirvolny,16,16,0,4162,3019,49779
4172,nechcete,16,11,5,4162,4527,5101
4173,navstevu,16,12,4,4162,4133,6130
4174,suchy,16,8,8,4162,6340,2491
4175,starem,16,13,3,4162,3784,7493
4176,neprekvapilo,16,16,0,4162,3019,49779
4177,forme,16,15,1,4162,3239,20221
4178,vznikl,16,10,6,4162,5017,4065
4179,strategicky,16,13,3,4162,3784,7493
4180,foru,16,12,4,4162,4133,6130
4181,vodiku,16,14,2,4162,3490,10331
4182,mrtvy,16,6,10,4162,8443,1614
4183,museji,16,16,0,4162,3019,49779
4184,strategickeho,16,16,0,4162,3019,49779
4185,zahajit,16,14,2,4162,3490,10331
4186,tihle,16,12,4,4162,4133,6130
4187,lekar,16,13,3,4162,3784,7493
4188,hodny,16,7,9,4162,7246,1924
4189,podaril,16,10,6,4162,5017,4065
4190,svetem,16,14,2,4162,3490,10331
4191,ako,16,9,7,4162,5608,3140
4192,prdel,16,7,9,4162,7246,1924
4193,danou,16,8,8,4162,6340,2491
4194,neznam,16,9,7,4162,5608,3140
4195,pripravil,16,14,2,4162,3490,10331
4196,pozemku,16,13,3,4162,3784,7493
4197,konkurenci,16,12,4,4162,4133,6130
4198,nejmensi,16,13,3,4162,3784,7493
4199,dokazuje,16,10,6,4162,5017,4065
4200,dan,16,15,1,4162,3239,20221
4201,muzi,16,11,5,4162,4527,5101
4202,oskliva,16,1,15,4162,43884,809
4203,srn,16,9,7,4162,5608,3140
4204,peklo,16,12,4,4162,4133,6130
4205,ihned,16,13,3,4162,3784,7493
4206,atomovou,16,14,2,4162,3490,10331
4207,atomovky,16,10,6,4162,5017,4065
4208,vrazdu,16,8,8,4162,6340,2491
4209,pokusit,16,6,10,4162,8443,1614
4210,zna,16,12,4,4162,4133,6130
4211,limitu,16,15,1,4162,3239,20221
4212,jaderky,16,14,2,4162,3490,10331
4213,pomahat,16,13,3,4162,3784,7493
4214,smlouve,16,13,3,4162,3784,7493
4215,pomahaji,16,13,3,4162,3784,7493
4216,srandu,16,4,12,4162,12501,1179
4217,vystavi,16,12,4,4162,4133,6130
4218,odejde,16,8,8,4162,6340,2491
4219,primym,16,8,8,4162,6340,2491
4220,verze,16,12,4,4162,4133,6130
4221,odehral,16,9,7,4162,5608,3140
4222,prekvapeny,16,6,10,4162,8443,1614
4223,urcita,16,8,8,4162,6340,2491
4224,stihacky,16,15,1,4162,3239,20221
4225,brne,16,5,11,4162,10167,1363
4226,tusim,16,13,3,4162,3784,7493
4227,ota,16,10,6,4162,5017,4065
4228,vladnouci,16,14,2,4162,3490,10331
4229,surovin,16,14,2,4162,3490,10331
4230,merkel,16,11,5,4162,4527,5101
4231,otazek,16,13,3,4162,3784,7493
4232,civilizaci,16,16,0,4162,3019,49779
4233,smlouvou,16,14,2,4162,3490,10331
4234,dopady,16,15,1,4162,3239,20221
4235,pc,16,15,1,4162,3239,20221
4236,cilene,16,11,5,4162,4527,5101
4237,hlasat,16,10,6,4162,5017,4065
4238,referendum,16,12,4,4162,4133,6130
4239,vikend,16,7,9,4162,7246,1924
4240,patril,16,7,9,4162,7246,1924
4241,druh,16,13,3,4162,3784,7493
4242,dostaly,16,13,3,4162,3784,7493
4243,nechala,16,12,4,4162,4133,6130
4244,jablek,16,5,11,4162,10167,1363
4245,zenska,16,10,6,4162,5017,4065
4246,pripadna,16,13,3,4162,3784,7493
4247,kliku,16,8,8,4162,6340,2491
4248,reknete,16,9,7,4162,5608,3140
4249,obraz,16,11,5,4162,4527,5101
4250,vedeny,16,14,2,4162,3490,10331
4251,pripadny,16,16,0,4162,3019,49779
4252,pomohli,16,13,3,4162,3784,7493
4253,izraelem,16,14,2,4162,3490,10331
4254,zamyslet,16,14,2,4162,3490,10331
4255,bank,16,11,5,4162,4527,5101
4256,pracoval,16,14,2,4162,3490,10331
4257,power,16,15,1,4162,3239,20221
4258,metra,16,11,5,4162,4527,5101
4259,valkach,16,12,4,4162,4133,6130
4260,vrazda,16,11,5,4162,4527,5101
4261,istanbulu,16,10,6,4162,5017,4065
4262,celit,16,9,7,4162,5608,3140
4263,mnozstvim,16,14,2,4162,3490,10331
4264,spousty,16,14,2,4162,3490,10331
4265,dlouheho,16,13,3,4162,3784,7493
4266,jaderek,16,12,4,4162,4133,6130
4267,cinane,16,13,3,4162,3784,7493
4268,volnost,16,10,6,4162,5017,4065
4269,presvedcuje,16,15,1,4162,3239,20221
4270,konzulatu,16,7,9,4162,7246,1924
4271,slozeni,16,8,8,4162,6340,2491
4272,pentagonu,16,14,2,4162,3490,10331
4273,vecech,16,12,4,4162,4133,6130
4274,uskupeni,16,12,4,4162,4133,6130
4275,donekonecna,16,4,12,4162,12501,1179
4276,sovetskym,16,13,3,4162,3784,7493
4277,ulic,16,6,10,4162,8443,1614
4278,premysli,16,9,7,4162,5608,3140
4279,zmrazily,16,10,6,4162,5017,4065
4280,poloviny,16,14,2,4162,3490,10331
4281,mh,16,14,2,4162,3490,10331
4282,vlna,16,13,3,4162,3784,7493
4283,hoven,16,14,2,4162,3490,10331
4284,ostatnimi,16,13,3,4162,3784,7493
4285,idioti,16,9,7,4162,5608,3140
4286,ucil,16,3,13,4162,16064,1036
4287,casy,16,12,4,4162,4133,6130
4288,snazim,16,8,8,4162,6340,2491
4289,sovetskych,16,16,0,4162,3019,49779
4290,blize,16,14,2,4162,3490,10331
4291,solary,16,13,3,4162,3784,7493
4292,afganistanu,16,15,1,4162,3239,20221
4293,ucini,16,8,8,4162,6340,2491
4294,nevedi,16,12,4,4162,4133,6130
4295,ridici,16,13,3,4162,3784,7493
4296,nenapise,16,8,8,4162,6340,2491
4297,reforma,16,10,6,4162,5017,4065
4298,vyhodili,16,7,9,4162,7246,1924
4299,presneji,16,15,1,4162,3239,20221
4300,vyhoda,16,15,1,4162,3239,20221
4301,nezavisle,16,14,2,4162,3490,10331
4302,obava,16,10,6,4162,5017,4065
4303,izolaci,16,16,0,4162,3019,49779
4304,dnesnim,16,14,2,4162,3490,10331
4305,croplus,16,11,5,4162,4527,5101
4306,idiot,16,10,6,4162,5017,4065
4307,vydava,16,14,2,4162,3490,10331
4308,uvedeno,16,15,1,4162,3239,20221
4309,brity,16,15,1,4162,3239,20221
4310,meritku,16,15,1,4162,3239,20221
4311,dome,16,13,3,4162,3784,7493
4312,senatoru,16,9,7,4162,5608,3140
4313,urcitou,16,14,2,4162,3490,10331
4314,chapani,15,9,6,4503,5608,4065
4315,dokazete,15,5,10,4503,10167,1614
4316,haji,15,13,2,4503,3784,10331
4317,hral,15,14,1,4503,3490,20221
4318,nejdrazsi,15,13,2,4503,3784,10331
4319,podobna,15,13,2,4503,3784,10331
4320,ochrane,15,10,5,4503,5017,5101
4321,stejnym,15,14,1,4503,3490,20221
4322,podepsali,15,13,2,4503,3784,10331
4323,podstaty,15,14,1,4503,3490,20221
4324,ulozeni,15,15,0,4503,3239,49779
4325,iv,15,14,1,4503,3490,20221
4326,ukrajincu,15,12,3,4503,4133,7493
4327,vedy,15,15,0,4503,3239,49779
4328,sklep,15,7,8,4503,7246,2491
4329,lidove,15,8,7,4503,6340,3140
4330,nasobne,15,13,2,4503,3784,10331
4331,zeleznicni,15,10,5,4503,5017,5101
4332,leteckou,15,8,7,4503,6340,3140
4333,sklenikovych,15,14,1,4503,3490,20221
4334,vyjadruje,15,10,5,4503,5017,5101
4335,komunistech,15,7,8,4503,7246,2491
4336,moste,15,7,8,4503,7246,2491
4337,tych,15,7,8,4503,7246,2491
4338,valecneho,15,10,5,4503,5017,5101
4339,nezli,15,15,0,4503,3239,49779
4340,ruskymi,15,11,4,4503,4527,6130
4341,prislusne,15,14,1,4503,3490,20221
4342,odpovednosti,15,9,6,4503,5608,4065
4343,musk,15,15,0,4503,3239,49779
4344,valecny,15,7,8,4503,7246,2491
4345,podepsana,15,13,2,4503,3784,10331
4346,rude,15,12,3,4503,4133,7493
4347,konzervativni,15,5,10,4503,10167,1614
4348,nuklearnim,15,13,2,4503,3784,10331
4349,data,15,11,4,4503,4527,6130
4350,skvely,15,6,9,4503,8443,1924
4351,dosazeni,15,8,7,4503,6340,3140
4352,idiotu,15,8,7,4503,6340,3140
4353,scifi,15,12,3,4503,4133,7493
4354,produkty,15,15,0,4503,3239,49779
4355,zalozena,15,12,3,4503,4133,7493
4356,utocnych,15,10,5,4503,5017,5101
4357,matne,15,7,8,4503,7246,2491
4358,tahne,15,11,4,4503,4527,6130
4359,presunu,15,13,2,4503,3784,10331
4360,datum,15,11,4,4503,4527,6130
4361,smesne,15,11,4,4503,4527,6130
4362,zahajeni,15,10,5,4503,5017,5101
4363,nedavne,15,15,0,4503,3239,49779
4364,dulezitych,15,8,7,4503,6340,3140
4365,zadni,15,7,8,4503,7246,2491
4366,vznikne,15,13,2,4503,3784,10331
4367,letoun,15,11,4,4503,4527,6130
4368,zavazky,15,14,1,4503,3490,20221
4369,intenzivni,15,13,2,4503,3784,10331
4370,inteligentni,15,8,7,4503,6340,3140
4371,postavy,15,7,8,4503,7246,2491
4372,objektivni,15,11,4,4503,4527,6130
4373,presun,15,15,0,4503,3239,49779
4374,zmizi,15,7,8,4503,7246,2491
4375,vyhlaseni,15,9,6,4503,5608,4065
4376,netvrdim,15,13,2,4503,3784,10331
4377,diskusni,15,7,8,4503,7246,2491
4378,raduje,15,5,10,4503,10167,1614
4379,muslimske,15,13,2,4503,3784,10331
4380,soustavu,15,15,0,4503,3239,49779
4381,komunistum,15,3,12,4503,16064,1179
4382,vstoupit,15,8,7,4503,6340,3140
4383,nebrani,15,11,4,4503,4527,6130
4384,nedopadne,15,6,9,4503,8443,1924
4385,muceni,15,11,4,4503,4527,6130
4386,malou,15,8,7,4503,6340,3140
4387,odkazu,15,11,4,4503,4527,6130
4388,silna,15,12,3,4503,4133,7493
4389,zbyly,15,6,9,4503,8443,1924
4390,tezkych,15,10,5,4503,5017,5101
4391,kdokoli,15,11,4,4503,4527,6130
4392,prirody,15,11,4,4503,4527,6130
4393,mistopredsedu,15,9,6,4503,5608,4065
4394,regulovat,15,15,0,4503,3239,49779
4395,macron,15,12,3,4503,4133,7493
4396,lukas,15,11,4,4503,4527,6130
4397,vydobytky,15,7,8,4503,7246,2491
4398,prestal,15,9,6,4503,5608,4065
4399,nezname,15,9,6,4503,5608,4065
4400,babisem,15,8,7,4503,6340,3140
4401,budovy,15,12,3,4503,4133,7493
4402,papiru,15,10,5,4503,5017,5101
4403,httpswwwnovinkyczzahranicnievropaputinhrozievropejadernouodvetouhtml,15,5,10,4503,10167,1614
4404,spravnou,15,12,3,4503,4133,7493
4405,technickych,15,13,2,4503,3784,10331
4406,doprave,15,9,6,4503,5608,4065
4407,vydirani,15,15,0,4503,3239,49779
4408,vojne,15,7,8,4503,7246,2491
4409,pravidlo,15,5,10,4503,10167,1614
4410,technicka,15,13,2,4503,3784,10331
4411,pracovnich,15,13,2,4503,3784,10331
4412,uvedene,15,13,2,4503,3784,10331
4413,dvaceti,15,13,2,4503,3784,10331
4414,kazdych,15,11,4,4503,4527,6130
4415,modernizace,15,11,4,4503,4527,6130
4416,vozidla,15,12,3,4503,4133,7493
4417,dejte,15,11,4,4503,4527,6130
4418,oc,15,8,7,4503,6340,3140
4419,priznivci,15,10,5,4503,5017,5101
4420,prosla,15,7,8,4503,7246,2491
4421,skripala,15,11,4,4503,4527,6130
4422,stredoveku,15,13,2,4503,3784,10331
4423,vysvetli,15,11,4,4503,4527,6130
4424,josef,15,11,4,4503,4527,6130
4425,fukusima,15,15,0,4503,3239,49779
4426,duvody,15,13,2,4503,3784,10331
4427,vyzkumne,15,15,0,4503,3239,49779
4428,druzi,15,6,9,4503,8443,1924
4429,pravoslavne,15,9,6,4503,5608,4065
4430,prinese,15,10,5,4503,5017,5101
4431,reaguje,15,8,7,4503,6340,3140
4432,httpforumczpodlezemanabysedanadrabovanemelaplestdojaderneenergetiky,15,14,1,4503,3490,20221
4433,ceduli,15,7,8,4503,7246,2491
4434,cinskou,15,15,0,4503,3239,49779
4435,mj,15,13,2,4503,3784,10331
4436,lesy,15,7,8,4503,7246,2491
4437,ranu,15,8,7,4503,6340,3140
4438,potaz,15,12,3,4503,4133,7493
4439,laboratori,15,13,2,4503,3784,10331
4440,topeni,15,8,7,4503,6340,3140
4441,soustavy,15,15,0,4503,3239,49779
4442,kratce,15,11,4,4503,4527,6130
4443,mafie,15,10,5,4503,5017,5101
4444,prodava,15,10,5,4503,5017,5101
4445,azovskeho,15,3,12,4503,16064,1179
4446,katedre,15,6,9,4503,8443,1924
4447,pomohla,15,13,2,4503,3784,10331
4448,doziju,15,7,8,4503,7246,2491
4449,zivotem,15,6,9,4503,8443,1924
4450,evropskeho,15,10,5,4503,5017,5101
4451,zranenych,15,8,7,4503,6340,3140
4452,standardni,15,11,4,4503,4527,6130
4453,dovozu,15,15,0,4503,3239,49779
4454,zivotniho,15,14,1,4503,3490,20221
4455,stylem,15,10,5,4503,5017,5101
4456,kecu,15,8,7,4503,6340,3140
4457,zranen,15,11,4,4503,4527,6130
4458,budov,15,14,1,4503,3490,20221
4459,zelenych,15,14,1,4503,3490,20221
4460,citit,15,13,2,4503,3784,10331
4461,potencialne,15,15,0,4503,3239,49779
4462,nasledku,15,13,2,4503,3784,10331
4463,pomsta,15,7,8,4503,7246,2491
4464,izraelsky,15,14,1,4503,3490,20221
4465,pluk,15,7,8,4503,7246,2491
4466,ukor,15,13,2,4503,3784,10331
4467,delegace,15,6,9,4503,8443,1924
4468,cetla,15,6,9,4503,8443,1924
4469,jednostranne,15,14,1,4503,3490,20221
4470,ryze,15,10,5,4503,5017,5101
4471,bezplatne,15,5,10,4503,10167,1614
4472,dozvedeli,15,4,11,4503,12501,1363
4473,pistoli,15,11,4,4503,4527,6130
4474,souvisejici,15,14,1,4503,3490,20221
4475,rozumim,15,5,10,4503,10167,1614
4476,nenecha,15,12,3,4503,4133,7493
4477,vyzbroje,15,9,6,4503,5608,4065
4478,hybridni,15,14,1,4503,3490,20221
4479,instalovali,15,6,9,4503,8443,1924
4480,ladislav,15,15,0,4503,3239,49779
4481,politickeho,15,7,8,4503,7246,2491
4482,sergej,15,9,6,4503,5608,4065
4483,smysleni,15,7,8,4503,7246,2491
4484,dusledkem,15,13,2,4503,3784,10331
4485,dvere,15,7,8,4503,7246,2491
4486,koncentraku,15,6,9,4503,8443,1924
4487,valek,15,15,0,4503,3239,49779
4488,necitil,15,6,9,4503,8443,1924
4489,pocetni,15,7,8,4503,7246,2491
4490,objevilo,15,11,4,4503,4527,6130
4491,cfd,15,14,1,4503,3490,20221
4492,metody,15,12,3,4503,4133,7493
4493,propagandu,15,7,8,4503,7246,2491
4494,trpeli,15,6,9,4503,8443,1924
4495,predstavitel,15,11,4,4503,4527,6130
4496,odmitla,15,7,8,4503,7246,2491
4497,poprel,15,9,6,4503,5608,4065
4498,atp,15,13,2,4503,3784,10331
4499,umite,15,8,7,4503,6340,3140
4500,vyhovovala,15,6,9,4503,8443,1924
4501,nahore,15,14,1,4503,3490,20221
4502,mzdy,15,9,6,4503,5608,4065
4503,pyramida,15,9,6,4503,5608,4065
4504,chvilku,15,5,10,4503,10167,1614
4505,zapojeni,15,15,0,4503,3239,49779
4506,teploty,15,13,2,4503,3784,10331
4507,zdrazeni,15,15,0,4503,3239,49779
4508,in,15,15,0,4503,3239,49779
4509,poskoci,15,10,5,4503,5017,5101
4510,vcelku,15,7,8,4503,7246,2491
4511,kusy,15,7,8,4503,7246,2491
4512,posilit,15,9,6,4503,5608,4065
4513,severnim,15,13,2,4503,3784,10331
4514,posileni,15,14,1,4503,3490,20221
4515,kauze,15,13,2,4503,3784,10331
4516,bazi,15,15,0,4503,3239,49779
4517,news,15,14,1,4503,3490,20221
4518,jevi,15,15,0,4503,3239,49779
4519,solidni,15,13,2,4503,3784,10331
4520,normalizaci,15,7,8,4503,7246,2491
4521,smrtelne,15,12,3,4503,4133,7493
4522,duchody,15,9,6,4503,5608,4065
4523,tisku,15,9,6,4503,5608,4065
4524,znama,15,12,3,4503,4133,7493
4525,pary,15,9,6,4503,5608,4065
4526,telefonu,15,9,6,4503,5608,4065
4527,exploze,15,14,1,4503,3490,20221
4528,medialni,15,10,5,4503,5017,5101
4529,okruhu,15,13,2,4503,3784,10331
4530,divize,15,10,5,4503,5017,5101
4531,pojem,15,12,3,4503,4133,7493
4532,nevedomi,15,9,6,4503,5608,4065
4533,vesmes,15,4,11,4503,12501,1363
4534,boris,15,5,10,4503,10167,1614
4535,doktori,15,5,10,4503,10167,1614
4536,vh,15,15,0,4503,3239,49779
4537,vyhradne,15,12,3,4503,4133,7493
4538,predstavil,15,5,10,4503,10167,1614
4539,nevzpominam,15,5,10,4503,10167,1614
4540,veskery,15,13,2,4503,3784,10331
4541,ucelove,15,7,8,4503,7246,2491
4542,nize,15,14,1,4503,3490,20221
4543,souhlasi,15,14,1,4503,3490,20221
4544,mysleli,15,10,5,4503,5017,5101
4545,reference,15,15,0,4503,3239,49779
4546,gorbacova,15,13,2,4503,3784,10331
4547,ridit,15,8,7,4503,6340,3140
4548,herec,15,7,8,4503,7246,2491
4549,slovum,15,9,6,4503,5608,4065
4550,dilu,15,13,2,4503,3784,10331
4551,erdogan,15,14,1,4503,3490,20221
4552,nesmyslu,15,14,1,4503,3490,20221
4553,spal,15,7,8,4503,7246,2491
4554,httpsarchivihnedczcprocmadarskypaksnenivzoremprotemelinruskovedetvrdouinformacnivalkuzadostavbuceskychjadernychelektraren,15,15,0,4503,3239,49779
4555,garanci,15,15,0,4503,3239,49779
4556,kola,15,6,9,4503,8443,1924
4557,vyucovani,15,6,9,4503,8443,1924
4558,pozaduje,15,9,6,4503,5608,4065
4559,vypuknuti,15,9,6,4503,5608,4065
4560,vystaven,15,7,8,4503,7246,2491
4561,milan,15,11,4,4503,4527,6130
4562,dostavalo,15,9,6,4503,5608,4065
4563,zatez,15,13,2,4503,3784,10331
4564,primy,15,11,4,4503,4527,6130
4565,vyhodnejsi,15,12,3,4503,4133,7493
4566,pusu,15,7,8,4503,7246,2491
4567,ukazali,15,8,7,4503,6340,3140
4568,nezda,15,11,4,4503,4527,6130
4569,asii,15,14,1,4503,3490,20221
4570,kontrakt,15,8,7,4503,6340,3140
4571,nemcu,15,14,1,4503,3490,20221
4572,elitni,15,7,8,4503,7246,2491
4573,onen,15,13,2,4503,3784,10331
4574,nelibilo,15,6,9,4503,8443,1924
4575,zlata,15,14,1,4503,3490,20221
4576,ukazala,15,12,3,4503,4133,7493
4577,odchazeji,15,13,2,4503,3784,10331
4578,sestreleni,15,15,0,4503,3239,49779
4579,hlava,15,9,6,4503,5608,4065
4580,dnesnich,15,13,2,4503,3784,10331
4581,preventivne,15,14,1,4503,3490,20221
4582,vyhodnoti,15,7,8,4503,7246,2491
4583,janda,15,7,8,4503,7246,2491
4584,zakazu,15,7,8,4503,7246,2491
4585,zneuziva,15,9,6,4503,5608,4065
4586,otroctvi,15,2,13,4503,22971,1036
4587,prehledem,15,7,8,4503,7246,2491
4588,priklady,15,14,1,4503,3490,20221
4589,zbroji,15,9,6,4503,5608,4065
4590,generalniho,15,8,7,4503,6340,3140
4591,chvali,15,14,1,4503,3490,20221
4592,garantoval,15,9,6,4503,5608,4065
4593,casopisu,15,11,4,4503,4527,6130
4594,garantovanou,15,9,6,4503,5608,4065
4595,plynovodu,15,14,1,4503,3490,20221
4596,vyuzivat,15,11,4,4503,4527,6130
4597,vyrobku,15,5,10,4503,10167,1614
4598,atmosfery,15,13,2,4503,3784,10331
4599,suro,15,3,12,4503,16064,1179
4600,nezacala,15,8,7,4503,6340,3140
4601,klasicky,15,14,1,4503,3490,20221
4602,celkovy,15,15,0,4503,3239,49779
4603,tvoji,15,7,8,4503,7246,2491
4604,odchod,15,8,7,4503,6340,3140
4605,setkavam,15,7,8,4503,7246,2491
4606,havlisticky,15,5,10,4503,10167,1614
4607,podivne,15,6,9,4503,8443,1924
4608,chuligana,15,5,10,4503,10167,1614
4609,prevrat,15,12,3,4503,4133,7493
4610,nahradi,15,13,2,4503,3784,10331
4611,klasicke,15,13,2,4503,3784,10331
4612,krade,15,10,5,4503,5017,5101
4613,sliby,15,12,3,4503,4133,7493
4614,flotily,15,12,3,4503,4133,7493
4615,zustavaji,15,7,8,4503,7246,2491
4616,laskave,15,4,11,4503,12501,1363
4617,obtizne,15,13,2,4503,3784,10331
4618,pohybu,15,10,5,4503,5017,5101
4619,poslouchat,15,8,7,4503,6340,3140
4620,hrubym,15,7,8,4503,7246,2491
4621,kosmickym,15,15,0,4503,3239,49779
4622,casteji,15,6,9,4503,8443,1924
4623,vladnou,15,13,2,4503,3784,10331
4624,snaze,15,13,2,4503,3784,10331
4625,saudsky,15,12,3,4503,4133,7493
4626,teroriste,15,10,5,4503,5017,5101
4627,chladici,15,14,1,4503,3490,20221
4628,krutosti,15,6,9,4503,8443,1924
4629,seznam,15,9,6,4503,5608,4065
4630,ucely,15,7,8,4503,7246,2491
4631,komousi,15,5,10,4503,10167,1614
4632,konstrukci,15,15,0,4503,3239,49779
4633,takovej,15,8,7,4503,6340,3140
4634,akcionare,15,15,0,4503,3239,49779
4635,smutne,15,9,6,4503,5608,4065
4636,rozvijet,15,11,4,4503,4527,6130
4637,plzen,15,13,2,4503,3784,10331
4638,hledani,15,15,0,4503,3239,49779
4639,predpokladu,15,13,2,4503,3784,10331
4640,marek,15,15,0,4503,3239,49779
4641,poslusneho,15,7,8,4503,7246,2491
4642,oznacili,15,9,6,4503,5608,4065
4643,benzin,15,14,1,4503,3490,20221
4644,fatalni,15,13,2,4503,3784,10331
4645,dano,15,13,2,4503,3784,10331
4646,zlocinneho,15,7,8,4503,7246,2491
4647,realnou,15,9,6,4503,5608,4065
4648,vyhrozovani,15,15,0,4503,3239,49779
4649,ciziho,15,13,2,4503,3784,10331
4650,trvalo,15,12,3,4503,4133,7493
4651,ukazka,15,6,9,4503,8443,1924
4652,komplexu,15,12,3,4503,4133,7493
4653,oznameni,15,15,0,4503,3239,49779
4654,minule,15,11,4,4503,4527,6130
4655,vymyslel,15,13,2,4503,3784,10331
4656,zbytecny,15,4,11,4503,12501,1363
4657,dalsimu,15,12,3,4503,4133,7493
4658,hruza,15,11,4,4503,4527,6130
4659,protiraketove,15,11,4,4503,4527,6130
4660,zemedelstvi,15,13,2,4503,3784,10331
4661,diplomaticke,15,15,0,4503,3239,49779
4662,presvedcen,15,13,2,4503,3784,10331
4663,vydalo,15,13,2,4503,3784,10331
4664,slaby,15,5,10,4503,10167,1614
4665,oko,15,4,11,4503,12501,1363
4666,presvedcil,15,5,10,4503,10167,1614
4667,samotna,15,12,3,4503,4133,7493
4668,tvrdou,15,13,2,4503,3784,10331
4669,vyhrali,15,5,10,4503,10167,1614
4670,pudu,15,10,5,4503,5017,5101
4671,israel,15,9,6,4503,5608,4065
4672,zabavu,15,7,8,4503,7246,2491
4673,spojena,15,14,1,4503,3490,20221
4674,upozornuji,15,14,1,4503,3490,20221
4675,zapadnim,15,13,2,4503,3784,10331
4676,expertu,15,15,0,4503,3239,49779
4677,demokraticke,15,11,4,4503,4527,6130
4678,lidstvu,15,13,2,4503,3784,10331
4679,prezije,15,11,4,4503,4527,6130
4680,pude,15,11,4,4503,4527,6130
4681,vladli,15,6,9,4503,8443,1924
4682,myli,15,3,12,4503,16064,1179
4683,komisi,15,14,1,4503,3490,20221
4684,chystaji,15,12,3,4503,4133,7493
4685,pocitu,15,5,10,4503,10167,1614
4686,federalni,15,10,5,4503,5017,5101
4687,zapotrebi,15,15,0,4503,3239,49779
4688,arabii,15,12,3,4503,4133,7493
4689,predpovedi,15,13,2,4503,3784,10331
4690,referendu,15,13,2,4503,3784,10331
4691,pozlatko,14,6,8,4897,8443,2491
4692,nebral,14,6,8,4897,8443,2491
4693,vzdelavani,14,13,1,4897,3784,20221
4694,vzniknout,14,10,4,4897,5017,6130
4695,sprosta,14,6,8,4897,8443,2491
4696,vypadek,14,7,7,4897,7246,3140
4697,uvedomuje,14,8,6,4897,6340,4065
4698,rikas,14,11,3,4897,4527,7493
4699,ochotno,14,5,9,4897,10167,1924
4700,vozidlo,14,10,4,4897,5017,6130
4701,spolecenskeho,14,4,10,4897,12501,1614
4702,volnem,14,14,0,4897,3490,49779
4703,zvirata,14,13,1,4897,3784,20221
4704,nehode,14,10,4,4897,5017,6130
4705,ssm,14,5,9,4897,10167,1924
4706,pozaduji,14,5,9,4897,10167,1924
4707,supervelmoci,14,14,0,4897,3490,49779
4708,nechaji,14,12,2,4897,4133,10331
4709,bombach,14,3,11,4897,16064,1363
4710,vrstva,14,5,9,4897,10167,1924
4711,zverejnen,14,4,10,4897,12501,1614
4712,dnesniho,14,7,7,4897,7246,3140
4713,spoluzakovi,14,6,8,4897,8443,2491
4714,pravdepodobnosti,14,12,2,4897,4133,10331
4715,monopol,14,10,4,4897,5017,6130
4716,problematice,14,13,1,4897,3784,20221
4717,reknou,14,11,3,4897,4527,7493
4718,tohodo,14,14,0,4897,3490,49779
4719,vzpomenou,14,5,9,4897,10167,1924
4720,nedokazalo,14,5,9,4897,10167,1924
4721,dnesnimu,14,6,8,4897,8443,2491
4722,mocnost,14,13,1,4897,3784,20221
4723,odmeny,14,8,6,4897,6340,4065
4724,uzavreny,14,6,8,4897,8443,2491
4725,pratelstvi,14,13,1,4897,3784,20221
4726,realnych,14,12,2,4897,4133,10331
4727,reformator,14,8,6,4897,6340,4065
4728,vaclava,14,12,2,4897,4133,10331
4729,priznal,14,9,5,4897,5608,5101
4730,obycejny,14,10,4,4897,5017,6130
4731,dnem,14,8,6,4897,6340,4065
4732,neutralni,14,13,1,4897,3784,20221
4733,akt,14,8,6,4897,6340,4065
4734,httpszpravyidnesczputinraketyjadernaodvetaevroparuskousafnozahranicniaspxcazahranicniremy,14,4,10,4897,12501,1614
4735,luganske,14,3,11,4897,16064,1363
4736,necim,14,9,5,4897,5608,5101
4737,odlozeni,14,13,1,4897,3784,20221
4738,valci,14,13,1,4897,3784,20221
4739,dluh,14,11,3,4897,4527,7493
4740,uznal,14,6,8,4897,8443,2491
4741,konstatoval,14,5,9,4897,10167,1924
4742,vrazi,14,6,8,4897,8443,2491
4743,kovy,14,14,0,4897,3490,49779
4744,udrzi,14,11,3,4897,4527,7493
4745,pristupu,14,12,2,4897,4133,10331
4746,obvineni,14,10,4,4897,5017,6130
4747,administrativni,14,14,0,4897,3490,49779
4748,loni,14,13,1,4897,3784,20221
4749,realite,14,12,2,4897,4133,10331
4750,ukazu,14,8,6,4897,6340,4065
4751,mlci,14,7,7,4897,7246,3140
4752,zabavy,14,6,8,4897,8443,2491
4753,divadla,14,6,8,4897,8443,2491
4754,resil,14,7,7,4897,7246,3140
4755,skaly,14,7,7,4897,7246,3140
4756,odberu,14,13,1,4897,3784,20221
4757,rim,14,7,7,4897,7246,3140
4758,respektcz,14,12,2,4897,4133,10331
4759,reformnim,14,8,6,4897,6340,4065
4760,probihalo,14,14,0,4897,3490,49779
4761,srbska,14,13,1,4897,3784,20221
4762,skladovani,14,14,0,4897,3490,49779
4763,veze,14,11,3,4897,4527,7493
4764,uzavrene,14,10,4,4897,5017,6130
4765,detech,14,6,8,4897,8443,2491
4766,spolupracovat,14,8,6,4897,6340,4065
4767,moskvou,14,11,3,4897,4527,7493
4768,skladu,14,12,2,4897,4133,10331
4769,odbornika,14,8,6,4897,6340,4065
4770,ridic,14,7,7,4897,7246,3140
4771,sprava,14,9,5,4897,5608,5101
4772,britum,14,14,0,4897,3490,49779
4773,reklaktera,14,14,0,4897,3490,49779
4774,pracujete,14,8,6,4897,6340,4065
4775,rikame,14,5,9,4897,10167,1924
4776,ukazky,14,6,8,4897,8443,2491
4777,genialni,14,10,4,4897,5017,6130
4778,adekvatne,14,10,4,4897,5017,6130
4779,prisly,14,13,1,4897,3784,20221
4780,udery,14,8,6,4897,6340,4065
4781,zdejsich,14,4,10,4897,12501,1614
4782,volal,14,2,12,4897,22971,1179
4783,zdrojich,14,14,0,4897,3490,49779
4784,aegis,14,12,2,4897,4133,10331
4785,zvysi,14,9,5,4897,5608,5101
4786,vynikajici,14,13,1,4897,3784,20221
4787,hlupaka,14,6,8,4897,8443,2491
4788,mladeho,14,5,9,4897,10167,1924
4789,zmenam,14,7,7,4897,7246,3140
4790,zamoreni,14,14,0,4897,3490,49779
4791,pdrabova,14,14,0,4897,3490,49779
4792,stihacka,14,6,8,4897,8443,2491
4793,dosah,14,13,1,4897,3784,20221
4794,vyreseni,14,10,4,4897,5017,6130
4795,novinarum,14,13,1,4897,3784,20221
4796,bal,14,4,10,4897,12501,1614
4797,peci,14,11,3,4897,4527,7493
4798,nenarazim,14,6,8,4897,8443,2491
4799,polovine,14,8,6,4897,6340,4065
4800,podepsat,14,7,7,4897,7246,3140
4801,jadernichrti,14,14,0,4897,3490,49779
4802,polske,14,10,4,4897,5017,6130
4803,vydirat,14,11,3,4897,4527,7493
4804,vedlo,14,14,0,4897,3490,49779
4805,psalo,14,8,6,4897,6340,4065
4806,blesku,14,6,8,4897,8443,2491
4807,cistou,14,13,1,4897,3784,20221
4808,prinuti,14,6,8,4897,8443,2491
4809,pomery,14,8,6,4897,6340,4065
4810,blbejsimi,14,6,8,4897,8443,2491
4811,prestanou,14,8,6,4897,6340,4065
4812,slozil,14,5,9,4897,10167,1924
4813,podilel,14,9,5,4897,5608,5101
4814,verici,14,5,9,4897,10167,1924
4815,vladnich,14,11,3,4897,4527,7493
4816,umela,14,13,1,4897,3784,20221
4817,nasimi,14,13,1,4897,3784,20221
4818,chytit,14,2,12,4897,22971,1179
4819,sousedni,14,14,0,4897,3490,49779
4820,celek,14,12,2,4897,4133,10331
4821,sousedu,14,13,1,4897,3784,20221
4822,urednici,14,10,4,4897,5017,6130
4823,vladou,14,6,8,4897,8443,2491
4824,uredniky,14,9,5,4897,5608,5101
4825,princip,14,13,1,4897,3784,20221
4826,zlodeji,14,12,2,4897,4133,10331
4827,cekam,14,3,11,4897,16064,1363
4828,prumerne,14,11,3,4897,4527,7493
4829,prumerny,14,11,3,4897,4527,7493
4830,prumeru,14,13,1,4897,3784,20221
4831,klima,14,13,1,4897,3784,20221
4832,prumyslovych,14,8,6,4897,6340,4065
4833,projevy,14,13,1,4897,3784,20221
4834,studente,14,6,8,4897,8443,2491
4835,sankcim,14,14,0,4897,3490,49779
4836,stb,14,4,10,4897,12501,1614
4837,castic,14,10,4,4897,5017,6130
4838,slovanu,14,11,3,4897,4527,7493
4839,clen,14,8,6,4897,6340,4065
4840,ulohu,14,11,3,4897,4527,7493
4841,popis,14,9,5,4897,5608,5101
4842,zakulisi,14,14,0,4897,3490,49779
4843,nybrz,14,13,1,4897,3784,20221
4844,smradlave,14,5,9,4897,10167,1924
4845,domnivali,14,6,8,4897,8443,2491
4846,domnenka,14,6,8,4897,8443,2491
4847,knihu,14,7,7,4897,7246,3140
4848,naposledy,14,7,7,4897,7246,3140
4849,kusu,14,11,3,4897,4527,7493
4850,opatrne,14,6,8,4897,8443,2491
4851,stavenisti,14,14,0,4897,3490,49779
4852,popsat,14,9,5,4897,5608,5101
4853,staveni,14,13,1,4897,3784,20221
4854,vecera,14,8,6,4897,6340,4065
4855,zenam,14,8,6,4897,6340,4065
4856,zakladnim,14,10,4,4897,5017,6130
4857,castice,14,13,1,4897,3784,20221
4858,podepsal,14,14,0,4897,3490,49779
4859,uci,14,9,5,4897,5608,5101
4860,zeptam,14,11,3,4897,4527,7493
4861,stenice,14,6,8,4897,8443,2491
4862,citi,14,9,5,4897,5608,5101
4863,knize,14,11,3,4897,4527,7493
4864,orbana,14,14,0,4897,3490,49779
4865,citim,14,14,0,4897,3490,49779
4866,nu,14,13,1,4897,3784,20221
4867,studentu,14,11,3,4897,4527,7493
4868,nucenych,14,6,8,4897,8443,2491
4869,potrebujete,14,12,2,4897,4133,10331
4870,kvot,14,8,6,4897,6340,4065
4871,nemuselo,14,8,6,4897,6340,4065
4872,hod,14,9,5,4897,5608,5101
4873,vlastnosti,14,9,5,4897,5608,5101
4874,opravnene,14,11,3,4897,4527,7493
4875,nezapomente,14,12,2,4897,4133,10331
4876,naboj,14,5,9,4897,10167,1924
4877,vedecke,14,10,4,4897,5017,6130
4878,cizich,14,13,1,4897,3784,20221
4879,blizici,14,14,0,4897,3490,49779
4880,vladne,14,7,7,4897,7246,3140
4881,lasku,14,7,7,4897,7246,3140
4882,poradili,14,6,8,4897,8443,2491
4883,hloubky,14,8,6,4897,6340,4065
4884,nick,14,5,9,4897,10167,1924
4885,draze,14,13,1,4897,3784,20221
4886,les,14,3,11,4897,16064,1363
4887,lepsiho,14,12,2,4897,4133,10331
4888,schvalila,14,6,8,4897,8443,2491
4889,vyjadrovani,14,3,11,4897,16064,1363
4890,dovolil,14,8,6,4897,6340,4065
4891,taborech,14,6,8,4897,8443,2491
4892,velkymi,14,9,5,4897,5608,5101
4893,padesati,14,13,1,4897,3784,20221
4894,umoznuje,14,12,2,4897,4133,10331
4895,matkam,14,5,9,4897,10167,1924
4896,nepovedlo,14,4,10,4897,12501,1614
4897,rozmistovat,14,10,4,4897,5017,6130
4898,priciny,14,5,9,4897,10167,1924
4899,zjisti,14,11,3,4897,4527,7493
4900,venuje,14,14,0,4897,3490,49779
4901,nahlas,14,4,10,4897,12501,1614
4902,lekare,14,7,7,4897,7246,3140
4903,rozmisti,14,13,1,4897,3784,20221
4904,jel,14,12,2,4897,4133,10331
4905,bezneho,14,6,8,4897,8443,2491
4906,zastaveni,14,10,4,4897,5017,6130
4907,evropou,14,11,3,4897,4527,7493
4908,rozpoutani,14,14,0,4897,3490,49779
4909,zasoby,14,14,0,4897,3490,49779
4910,strelby,14,11,3,4897,4527,7493
4911,syrske,14,11,3,4897,4527,7493
4912,hm,14,5,9,4897,10167,1924
4913,prijimat,14,8,6,4897,6340,4065
4914,unikatni,14,7,7,4897,7246,3140
4915,narodnich,14,9,5,4897,5608,5101
4916,letat,14,6,8,4897,8443,2491
4917,cest,14,13,1,4897,3784,20221
4918,smerovani,14,7,7,4897,7246,3140
4919,soucasnou,14,11,3,4897,4527,7493
4920,cestovani,14,12,2,4897,4133,10331
4921,jednotka,14,7,7,4897,7246,3140
4922,narok,14,14,0,4897,3490,49779
4923,nicem,14,11,3,4897,4527,7493
4924,zidu,14,13,1,4897,3784,20221
4925,drancovani,14,14,0,4897,3490,49779
4926,hloupejsiho,14,6,8,4897,8443,2491
4927,sdelil,14,13,1,4897,3784,20221
4928,pachatele,14,14,0,4897,3490,49779
4929,jakymi,14,11,3,4897,4527,7493
4930,extra,14,12,2,4897,4133,10331
4931,mapu,14,11,3,4897,4527,7493
4932,vyhozen,14,8,6,4897,6340,4065
4933,pokaral,14,14,0,4897,3490,49779
4934,verbez,14,6,8,4897,8443,2491
4935,led,14,8,6,4897,6340,4065
4936,choval,14,11,3,4897,4527,7493
4937,prevzit,14,12,2,4897,4133,10331
4938,leckdy,14,5,9,4897,10167,1924
4939,japonci,14,14,0,4897,3490,49779
4940,rozsirovani,14,13,1,4897,3784,20221
4941,nepusti,14,13,1,4897,3784,20221
4942,tvora,14,6,8,4897,8443,2491
4943,stopem,14,6,8,4897,8443,2491
4944,nerostne,14,14,0,4897,3490,49779
4945,pokousel,14,14,0,4897,3490,49779
4946,vyhody,14,10,4,4897,5017,6130
4947,dostavaji,14,9,5,4897,5608,5101
4948,pater,14,8,6,4897,6340,4065
4949,zlatou,14,5,9,4897,10167,1924
4950,hlav,14,6,8,4897,8443,2491
4951,pojistka,14,3,11,4897,16064,1363
4952,ovladani,14,12,2,4897,4133,10331
4953,strachu,14,11,3,4897,4527,7493
4954,nepocita,14,8,6,4897,6340,4065
4955,jenomze,14,13,1,4897,3784,20221
4956,hmoty,14,11,3,4897,4527,7493
4957,nepotrebuje,14,10,4,4897,5017,6130
4958,nadpis,14,12,2,4897,4133,10331
4959,cenzura,14,6,8,4897,8443,2491
4960,podnikum,14,8,6,4897,6340,4065
4961,vysledkem,14,12,2,4897,4133,10331
4962,strasi,14,10,4,4897,5017,6130
4963,pohyb,14,11,3,4897,4527,7493
4964,nepolozila,14,8,6,4897,6340,4065
4965,ozareni,14,13,1,4897,3784,20221
4966,jasneostre,14,14,0,4897,3490,49779
4967,chlapce,14,11,3,4897,4527,7493
4968,nepodaril,14,8,6,4897,6340,4065
4969,propagacni,14,6,8,4897,8443,2491
4970,belgii,14,14,0,4897,3490,49779
4971,ovlivnit,14,13,1,4897,3784,20221
4972,sebevrazdu,14,13,1,4897,3784,20221
4973,strilet,14,6,8,4897,8443,2491
4974,poradi,14,12,2,4897,4133,10331
4975,ruzni,14,5,9,4897,10167,1924
4976,kurva,14,5,9,4897,10167,1924
4977,czechtv,14,13,1,4897,3784,20221
4978,utoci,14,10,4,4897,5017,6130
4979,elektriku,14,13,1,4897,3784,20221
4980,test,14,10,4,4897,5017,6130
4981,minulych,14,12,2,4897,4133,10331
4982,uctou,14,6,8,4897,8443,2491
4983,utocit,14,13,1,4897,3784,20221
4984,krku,14,6,8,4897,8443,2491
4985,pripravit,14,13,1,4897,3784,20221
4986,radovat,14,6,8,4897,8443,2491
4987,piloti,14,9,5,4897,5608,5101
4988,muslimu,14,14,0,4897,3490,49779
4989,vuz,14,7,7,4897,7246,3140
4990,nejelo,14,8,6,4897,6340,4065
4991,nejeli,14,8,6,4897,6340,4065
4992,bojem,14,9,5,4897,5608,5101
4993,analyzy,14,13,1,4897,3784,20221
4994,analyze,14,5,9,4897,10167,1924
4995,nejedna,14,10,4,4897,5017,6130
4996,krivdu,14,5,9,4897,10167,1924
4997,postavene,14,14,0,4897,3490,49779
4998,libit,14,12,2,4897,4133,10331
4999,tesit,14,11,3,4897,4527,7493
5000,obehu,14,14,0,4897,3490,49779
