,word_text,word_count_zminka,word_count_zminka_rel,word_count_zminka_nerel,word_zminka_rank,word_zminka_rank_rel,word_zminka_rank_nerel
0,jaderne,1759,1651,108,1,1,6
1,jadernych,938,900,38,2,2,167
2,jadernou,850,807,43,3,3,128
3,usa,793,717,76,4,4,21
4,let,714,612,102,5,7,8
5,rt,698,657,41,6,5,141
6,elektrarny,667,647,20,7,6,575
7,rusko,664,607,57,8,8,62
8,takze,570,438,132,9,12,1
9,podle,561,444,117,10,11,3
10,dnes,501,412,89,11,15,14
11,jaderna,494,459,35,12,10,198
12,zbrane,492,478,14,13,9,1009
13,putin,488,438,50,14,12,88
14,jaderny,475,416,59,15,14,56
15,nema,469,377,92,16,16,13
16,kdyby,440,335,105,17,22,7
17,ruska,440,369,71,17,17,27
18,lidi,415,300,115,19,32,4
19,stejne,413,312,101,20,28,9
20,no,410,279,131,21,37,2
21,nebude,407,332,75,22,23,23
22,ci,407,337,70,22,21,29
23,nikdo,399,306,93,24,30,11
24,nove,392,326,66,25,24,39
25,vice,390,319,71,26,25,27
26,rusku,389,351,38,27,18,167
27,evrope,386,351,35,28,18,198
28,zemi,386,316,70,28,26,29
29,dobre,372,260,112,30,42,5
30,stat,358,304,54,31,31,71
31,bloku,354,340,14,32,20,1009
32,pripade,351,283,68,33,36,35
33,zase,348,249,99,34,47,10
34,roku,338,296,42,35,33,134
35,cr,337,278,59,36,38,56
36,stale,337,272,65,36,41,41
37,energie,334,308,26,38,29,356
38,vsechny,332,274,58,39,40,59
39,zeme,326,278,48,40,38,98
40,veci,322,260,62,41,42,48
41,elektraren,321,313,8,42,27,2605
42,navic,318,252,66,43,46,39
43,prvni,312,237,75,44,53,23
44,zbrani,311,284,27,45,35,329
45,jaderneho,310,294,16,46,34,819
46,opravdu,310,229,81,46,61,17
47,prave,307,240,67,48,49,37
48,pouze,307,239,68,48,51,35
49,vic,305,233,72,50,57,26
50,par,303,234,69,51,55,32
51,nato,302,256,46,52,44,109
52,nikdy,300,221,79,53,70,19
53,eu,299,248,51,54,48,83
54,meli,295,231,64,55,59,43
55,dobe,288,239,49,56,51,93
56,vse,286,234,52,57,55,78
57,zeman,283,200,83,58,78,15
58,velmi,282,229,53,59,61,74
59,nejaky,280,229,51,60,61,83
60,rakety,279,254,25,61,45,390
61,svete,277,228,49,62,64,93
62,problem,276,218,58,63,72,59
63,samozrejme,271,209,62,64,75,48
64,cele,270,227,43,65,66,128
65,statu,269,222,47,66,68,103
66,jasne,268,212,56,67,73,66
67,ruske,267,237,30,68,53,272
68,roce,266,227,39,70,66,156
69,uplne,266,198,68,70,79,35
70,valky,266,240,26,70,49,356
71,lide,265,202,63,72,77,46
72,uzemi,262,233,29,73,57,289
73,nejsou,260,210,50,74,74,88
74,rusove,258,228,30,75,64,272
75,at,258,181,77,75,94,20
76,kazdy,257,196,61,77,82,50
77,drabova,257,228,29,77,64,289
78,valku,255,222,33,79,68,220
79,valka,254,221,33,80,70,220
80,zcela,241,177,64,82,102,43
81,takove,241,197,44,82,80,122
82,vsech,241,197,44,82,80,122
83,vetsi,239,190,49,84,89,93
84,dokonce,239,191,48,84,87,98
85,diky,238,192,46,86,85,109
86,dost,237,179,58,87,96,59
87,kterou,236,196,40,88,82,146
88,zde,234,187,47,89,92,103
89,raket,233,206,27,90,76,329
90,nevim,228,162,66,92,117,39
91,zda,228,168,60,92,107,53
92,statni,228,192,36,92,85,186
93,ruskem,226,191,35,94,87,198
94,nejvetsi,225,188,37,95,91,175
95,prezident,223,177,46,96,102,109
96,hlavne,222,163,59,97,115,56
97,myslim,221,160,61,98,121,50
98,nejen,220,165,55,99,113,69
99,opet,219,179,40,100,96,146
100,tento,219,170,49,100,105,93
101,svou,216,160,56,102,121,66
102,delat,215,158,57,103,125,62
103,sice,213,157,56,104,128,66
104,rekl,213,166,47,104,110,103
105,smlouvy,212,185,27,106,93,329
106,fakt,211,147,64,108,152,43
107,jine,211,154,57,108,133,62
108,ni,211,178,33,108,99,220
109,mela,211,166,45,108,110,115
110,teto,210,178,32,111,99,234
111,novych,207,192,15,113,85,904
112,ovsem,207,168,39,113,107,156
113,posledni,207,156,51,113,130,83
114,mozne,205,160,45,116,121,115
115,presne,205,149,56,116,147,66
116,nyni,205,160,45,116,121,115
117,dalsich,204,165,39,118,113,156
118,sam,203,143,60,120,161,53
119,zdroje,203,189,14,120,90,1009
120,vlastni,203,157,46,120,128,109
121,elektriny,198,178,20,122,99,575
122,jadernym,197,179,18,123,96,689
123,sveta,197,171,26,123,104,356
124,kolem,196,152,44,126,139,122
125,svet,196,163,33,126,115,220
126,pan,196,120,76,126,226,21
127,nejake,195,145,50,130,156,88
128,letech,195,157,38,130,128,167
129,misto,195,144,51,130,158,83
130,da,195,146,49,130,154,93
131,evropy,195,165,30,130,113,272
132,velke,194,160,34,133,121,209
133,clovek,194,125,69,133,207,32
134,totiz,193,154,39,135,133,156
135,staci,192,147,45,136,152,115
136,penize,192,153,39,136,137,156
137,prezidenta,191,166,25,138,110,390
138,svych,190,151,39,139,141,156
139,nuklearni,190,121,69,139,222,32
140,lepsi,189,129,60,141,195,53
141,strany,188,136,52,142,174,78
142,tyto,187,158,29,143,125,289
143,sveho,187,138,49,143,169,93
144,radioaktivni,186,133,53,145,183,74
145,ceske,185,158,27,146,125,329
146,jiste,185,150,35,146,144,198
147,vlada,184,161,23,148,118,454
148,kterych,182,169,13,149,106,1135
149,rozdil,182,132,50,149,187,88
150,bloky,181,177,4,152,102,6257
151,mimo,181,150,31,152,144,253
152,valce,181,143,38,152,161,167
153,ostatni,181,139,42,152,167,134
154,naopak,180,146,34,155,154,209
155,soucasne,180,154,26,155,133,356
156,staty,178,153,25,157,137,390
157,nemuze,178,131,47,157,190,103
158,podobne,177,143,34,159,161,209
159,skutecne,176,132,44,160,187,122
160,pane,176,125,51,160,207,83
161,predevsim,174,148,26,162,149,356
162,dela,174,126,48,162,203,98
163,melo,173,133,40,164,183,146
164,jadro,173,153,20,164,137,575
165,rika,172,117,55,166,245,69
166,svuj,172,130,42,166,193,134
167,cenu,171,134,37,169,179,175
168,rok,171,142,29,169,164,289
169,lze,171,130,41,169,193,141
170,nekolik,171,150,21,169,144,528
171,cas,170,127,43,173,199,128
172,utok,170,147,23,173,152,454
173,takovy,170,123,47,173,213,103
174,tohoto,168,124,44,175,210,122
175,sebe,168,115,53,175,256,74
176,naprosto,167,121,46,178,222,109
177,zadne,167,137,30,178,171,272
178,nebudou,167,125,42,178,207,134
179,rad,166,104,62,182,296,48
180,cely,166,132,34,182,187,209
181,hned,166,120,46,182,226,109
182,zareni,166,156,10,182,130,1723
183,trochu,166,116,50,182,249,88
184,zdroj,165,136,29,186,174,289
185,jo,165,84,81,186,417,17
186,pomoci,165,126,39,186,203,156
187,energii,164,149,15,190,147,904
188,oblasti,164,138,26,190,169,356
189,vsak,164,139,25,190,167,390
190,cca,164,145,19,190,156,626
191,dlouho,164,111,53,190,271,74
192,uhli,163,152,11,193,139,1469
193,miliard,163,148,15,193,149,904
194,tolik,162,119,43,196,231,128
195,dana,162,154,8,196,133,2605
196,zemana,162,137,25,196,171,390
197,bezpecnost,162,151,11,196,141,1469
198,jineho,161,125,36,200,207,186
199,cez,161,150,11,200,144,1469
200,atd,161,136,25,200,174,390
201,vlady,160,124,36,202,210,186
202,napr,160,140,20,202,165,575
203,mysli,159,119,40,204,231,146
204,nebylo,158,122,36,205,218,186
205,pritom,157,127,30,207,199,272
206,stoji,157,134,23,207,179,454
207,rusky,157,126,31,207,203,253
208,postavit,156,134,22,209,179,488
209,jenze,155,129,26,210,195,356
210,pise,154,122,32,212,218,234
211,prece,154,117,37,212,245,175
212,techto,154,123,31,212,213,253
213,novy,154,118,36,212,239,186
214,nekdy,153,114,39,216,261,156
215,cim,153,114,39,216,261,156
216,napriklad,153,134,19,216,179,626
217,vi,153,115,38,216,256,167
218,udelat,152,121,31,219,222,253
219,pry,151,118,33,220,239,220
220,americke,150,134,16,222,179,819
221,hrozi,150,143,7,222,161,3258
222,celou,150,119,31,222,231,253
223,vcetne,149,116,33,226,249,220
224,putina,149,121,28,226,222,309
225,americkych,149,132,17,226,187,754
226,noveho,149,118,31,226,239,253
227,slova,149,123,26,226,213,356
228,jake,149,118,31,226,239,253
229,zivot,148,116,32,230,249,234
230,nasledne,147,140,7,231,165,3258
231,nemecku,147,122,25,231,218,390
232,nejde,146,109,37,235,276,175
233,tato,146,115,31,235,256,253
234,bychom,146,128,18,235,197,689
235,nejlepsi,146,113,33,235,264,220
236,deti,146,103,43,235,299,128
237,dukovany,146,144,2,235,158,10460
238,takova,145,113,32,241,264,234
239,mnohem,145,110,35,241,274,198
240,rozhodne,145,122,23,241,218,454
241,praci,145,118,27,241,239,329
242,system,145,108,37,241,280,175
243,nakonec,145,113,32,241,264,234
244,snazi,144,105,39,245,292,156
245,situace,144,112,32,245,267,234
246,tuto,143,111,32,247,271,234
247,jadernymi,143,134,9,247,179,2037
248,pani,142,90,52,250,375,78
249,clanek,142,111,31,250,271,253
250,zdroju,142,123,19,250,213,626
251,mnozstvi,141,102,39,254,302,156
252,spise,141,109,32,254,276,234
253,dobu,141,115,26,254,256,356
254,doslo,141,108,33,254,280,220
255,svem,141,112,29,254,267,289
256,doletu,140,122,18,258,218,689
257,prace,140,94,46,258,345,109
258,pravda,140,98,42,258,323,134
259,politiku,139,111,28,263,271,309
260,evropa,139,118,21,263,239,528
261,stavet,139,131,8,263,190,2605
262,moznost,139,104,35,263,296,198
263,vyssi,139,108,31,263,280,253
264,clanku,139,115,24,263,256,422
265,energetiky,139,136,3,263,174,7621
266,reaktoru,138,127,11,269,199,1469
267,ruskych,138,119,19,269,231,626
268,rozhodnuti,138,108,30,269,280,272
269,znamena,138,112,26,269,267,356
270,chtel,138,94,44,269,345,122
271,mnoho,137,100,37,272,311,175
272,cast,137,102,35,272,302,198
273,vladimir,136,119,17,275,231,754
274,davno,136,106,30,275,289,272
275,znovu,136,94,42,275,345,134
276,zadny,136,114,22,275,261,488
277,sami,135,94,41,279,345,141
278,potreba,135,104,31,279,296,253
279,vetsina,135,110,25,279,274,390
280,vystavbu,135,130,5,279,193,5227
281,vazne,134,89,45,285,382,115
282,prijde,134,94,40,285,345,146
283,tem,134,95,39,285,337,156
284,jiny,134,98,36,285,323,186
285,milionu,134,102,32,285,302,234
286,moznosti,134,118,16,285,239,819
287,stredniho,134,116,18,285,249,689
288,trump,133,119,14,291,231,1009
289,druhe,133,101,32,291,306,234
290,temelin,133,127,6,291,199,4187
291,rijna,133,116,17,291,249,754
292,jednu,133,107,26,291,285,356
293,situaci,132,107,25,296,285,390
294,re,132,87,45,296,398,115
295,ramci,132,90,42,296,375,134
296,odvetou,132,132,0,296,187,49909
297,informace,132,99,33,296,316,220
298,mohli,131,98,33,300,323,220
299,elektrarnu,131,125,6,300,207,4187
300,cena,131,116,15,300,249,904
301,doby,130,99,31,304,316,253
302,sssr,130,112,18,304,267,689
303,plynu,130,115,15,304,256,904
304,cina,130,119,11,304,231,1469
305,oboru,130,115,15,304,256,904
306,babis,129,75,54,308,491,71
307,jedine,129,97,32,308,330,234
308,rekne,129,119,10,308,231,1723
309,radeji,128,86,42,312,407,134
310,svym,128,92,36,312,359,186
311,zrejme,128,106,22,312,289,488
312,oze,128,107,21,312,285,528
313,pana,128,98,30,312,323,272
314,zrovna,128,87,41,312,398,141
315,velky,127,99,28,317,316,309
316,pravdu,127,86,41,317,407,141
317,bud,127,102,25,317,302,390
318,nemecko,126,102,24,322,302,422
319,nejakou,126,97,29,322,330,289
320,plest,126,118,8,322,239,2605
321,jaky,126,90,36,322,375,186
322,dnesni,126,90,36,322,375,186
323,vec,126,94,32,322,345,234
324,alespon,126,90,36,322,375,186
325,rosatom,125,120,5,327,226,5227
326,spolecnosti,125,94,31,327,345,253
327,otazka,125,100,25,327,311,390
328,duvod,125,88,37,327,389,175
329,spis,124,88,36,332,389,186
330,nejsem,124,72,52,332,521,78
331,muzeme,124,104,20,332,296,575
332,mene,124,94,30,332,345,272
333,zadna,124,98,26,332,323,356
334,stalo,124,94,30,332,345,272
335,konecne,123,87,36,337,398,186
336,sem,123,79,44,337,451,122
337,roky,123,93,30,337,353,272
338,celkem,123,98,25,337,323,390
339,prakticky,122,93,29,342,353,289
340,reseni,122,100,22,342,311,488
341,vojenske,122,93,29,342,353,289
342,spatne,122,83,39,342,422,156
343,fyzika,122,107,15,342,285,904
344,primo,120,100,20,345,311,575
345,firmy,120,99,21,345,316,528
346,jadra,119,108,11,348,280,1469
347,elektrarna,119,117,2,348,245,10460
348,duvodu,119,91,28,348,367,309
349,velka,118,92,26,352,359,356
350,mohla,118,91,27,352,367,329
351,videt,118,96,22,352,333,488
352,americane,118,98,20,352,323,575
353,vite,118,86,32,352,407,234
354,klidne,118,91,27,352,367,329
355,vsem,117,83,34,357,422,209
356,neustale,117,96,21,357,333,528
357,nasich,117,99,18,357,316,689
358,svetove,116,84,32,359,417,234
359,dostavbu,115,108,7,362,280,3258
360,zahranici,115,81,34,362,435,209
361,systemu,115,81,34,362,435,209
362,nektere,115,95,20,362,337,575
363,moci,115,87,28,362,398,309
364,muset,114,96,18,368,333,689
365,kterym,114,78,36,368,462,186
366,mimochodem,114,95,19,368,337,626
367,lety,114,86,28,368,407,309
368,tvrdi,114,87,27,368,398,329
369,zaroven,114,98,16,368,323,819
370,okoli,114,92,22,368,359,488
371,spravne,113,80,33,373,442,220
372,dvou,113,82,31,373,429,253
373,typu,113,90,23,373,375,454
374,ziskala,112,101,11,375,306,1469
375,technologie,111,101,10,376,306,1723
376,blok,110,91,19,379,367,626
377,souhlasim,110,86,24,379,407,422
378,tehdy,110,86,24,379,407,422
379,pote,110,85,25,379,413,390
380,vzhledem,110,91,19,379,367,626
381,utoku,110,98,12,379,323,1282
382,informaci,109,91,18,384,367,689
383,senat,109,16,93,384,3148,11
384,nechce,109,78,31,384,462,253
385,ceny,109,85,24,384,413,422
386,vuci,108,96,12,390,333,1282
387,nemecka,108,94,14,390,345,1009
388,zbranemi,108,94,14,390,345,1009
389,cesta,108,78,30,390,462,272
390,americky,108,91,17,390,367,754
391,smysl,108,87,21,390,398,528
392,temer,108,88,20,390,389,575
393,podstate,108,88,20,390,389,575
394,fakultu,107,106,1,399,289,20351
395,jinych,107,87,20,399,398,575
396,elektrinu,107,100,7,399,311,3258
397,fyzikalne,107,106,1,399,289,20351
398,napsal,107,73,34,399,510,209
399,vystudovala,107,105,2,399,292,10460
400,volby,107,43,64,399,1046,43
401,vedeni,107,81,26,399,435,356
402,rychle,107,82,25,399,429,390
403,cela,107,79,28,399,451,309
404,smlouvu,106,91,15,405,367,904
405,odpadu,105,101,4,409,306,6257
406,slo,105,78,27,409,462,329
407,mezinarodni,105,89,16,409,382,819
408,stranu,105,73,32,409,510,234
409,horsi,105,82,23,409,429,454
410,domu,105,76,29,409,482,289
411,hlavni,105,83,22,409,422,488
412,tema,104,78,26,415,462,356
413,ciny,104,92,12,415,359,1282
414,vsude,104,75,29,415,491,289
415,nazor,104,81,23,415,435,454
416,inzenyrskou,104,104,0,415,296,49909
417,vim,104,73,31,415,510,253
418,druhou,103,78,25,423,462,390
419,zacit,103,88,15,423,389,904
420,politiky,103,77,26,423,473,356
421,dle,103,77,26,423,473,356
422,mohlo,103,91,12,423,367,1282
423,chvili,103,75,28,423,491,309
424,viz,103,79,24,423,451,422
425,cloveka,103,79,24,423,451,422
426,dostal,103,55,48,423,758,98
427,vody,103,65,38,423,596,167
428,svoje,102,74,28,431,501,309
429,zapad,102,81,21,431,435,528
430,muzete,102,76,26,431,482,356
431,casto,102,67,35,431,572,198
432,prumyslu,102,94,8,431,345,2605
433,konec,101,76,25,436,482,390
434,senatu,101,19,82,436,2644,16
435,takto,101,66,35,436,582,198
436,ceska,101,85,16,436,413,819
437,odstoupeni,101,87,14,436,398,1009
438,vede,100,74,26,442,501,356
439,presto,100,77,23,442,473,454
440,cvut,100,98,2,442,323,10460
441,nutne,100,78,22,442,462,488
442,sankce,100,82,18,442,429,689
443,hodin,100,77,23,442,473,454
444,svoji,100,79,21,442,451,528
445,delaji,100,78,22,442,462,488
446,zpusobem,99,79,20,450,451,575
447,vyroby,99,75,24,450,491,422
448,chteli,99,65,34,450,596,209
449,plne,99,87,12,450,398,1282
450,boji,99,77,22,450,473,488
451,republiky,99,73,26,450,510,356
452,problemy,99,88,11,450,389,1469
453,nekolika,98,75,23,458,491,454
454,vypada,98,61,37,458,657,175
455,lepe,98,71,27,458,533,329
456,nejvyssi,98,80,18,458,442,689
457,zmrd,98,92,6,458,359,4187
458,stoleti,98,72,26,458,521,356
459,dohody,98,71,27,458,533,329
460,skutecnosti,98,83,15,458,422,904
461,ohledne,98,77,21,458,473,528
462,sobe,98,69,29,458,552,289
463,treti,97,72,25,466,521,390
464,vaclavagh,97,97,0,466,330,49909
465,nelze,97,89,8,466,382,2605
466,dat,97,70,27,466,543,329
467,evropske,97,83,14,466,422,1009
468,lidem,96,64,32,474,611,234
469,nemci,96,87,9,474,398,2037
470,ruznych,96,67,29,474,572,289
471,naklady,96,87,9,474,398,2037
472,vyvoj,96,85,11,474,413,1469
473,km,96,82,14,474,429,1009
474,obdobi,96,76,20,474,482,575
475,miste,96,73,23,474,510,454
476,moznou,96,93,3,474,353,7621
477,sama,96,75,21,474,491,528
478,drive,96,79,17,474,451,754
479,sebou,96,75,21,474,491,528
480,zapadni,95,79,16,483,451,819
481,plyn,95,83,12,483,422,1282
482,titul,95,92,3,483,359,7621
483,vime,95,80,15,483,442,904
484,verejne,95,64,31,483,611,253
485,ktereho,94,64,30,490,611,272
486,pripadne,94,75,19,490,491,626
487,takoveho,94,68,26,490,563,356
488,spolecnost,94,77,17,490,473,754
489,obrany,94,74,20,490,501,575
490,silne,94,73,21,490,510,528
491,studiu,94,94,0,490,345,49909
492,dokud,94,72,22,490,521,488
493,nevi,94,71,23,490,533,454
494,pouzit,94,85,9,490,413,2037
495,obor,93,89,4,499,382,6257
496,tyce,93,74,19,499,501,626
497,jednoho,93,62,31,499,639,253
498,zapadu,93,68,25,499,563,390
499,radu,93,74,19,499,501,626
500,resit,93,68,25,499,563,390
501,vyrobu,93,72,21,499,521,528
502,aplikace,93,92,1,499,359,20351
503,ods,92,19,73,509,2644,25
504,tzv,92,68,24,509,563,422
505,prohlasil,92,68,24,509,563,422
506,casu,92,71,21,509,533,528
507,odpoved,92,69,23,509,552,454
508,provozu,92,86,6,509,407,4187
509,takovou,92,70,22,509,543,488
510,armady,92,65,27,509,596,329
511,ministr,92,77,15,509,473,904
512,vzdyt,92,64,28,509,611,309
513,zarizeni,92,78,14,509,462,1009
514,nicmene,91,73,18,517,510,689
515,ionizujiciho,91,90,1,517,375,20351
516,konci,91,68,23,517,563,454
517,kazde,91,70,21,517,543,528
518,souhlasit,91,80,11,517,442,1469
519,videl,90,62,28,524,639,309
520,nova,90,71,19,524,533,626
521,mluvit,90,69,21,524,552,528
522,dozimetrie,90,89,1,524,382,20351
523,koho,90,50,40,524,852,146
524,nazoru,90,77,13,524,473,1135
525,osobne,90,76,14,524,482,1009
526,odpad,90,71,19,524,533,626
527,zacal,90,66,24,524,582,422
528,svymi,89,56,33,536,737,220
529,doma,89,63,26,536,623,356
530,rady,89,76,13,536,482,1135
531,udajne,89,68,21,536,563,528
532,nemusi,89,75,14,536,491,1009
533,likvidaci,89,71,18,536,533,689
534,komu,89,69,20,536,552,575
535,nejaka,89,55,34,536,758,209
536,jej,89,58,31,536,701,253
537,phd,89,89,0,536,382,49909
538,hlediska,89,68,21,536,563,528
539,vetsinou,89,66,23,536,582,454
540,penez,89,69,20,536,552,575
541,nemam,89,53,36,536,795,186
542,venovala,89,89,0,536,382,49909
543,stavbu,88,81,7,547,435,3258
544,byste,88,50,38,547,852,167
545,prostredi,88,78,10,547,462,1723
546,doktorskemu,88,88,0,547,389,49909
547,reaktory,88,85,3,547,413,7621
548,sil,88,66,22,547,582,488
549,miru,88,75,13,547,491,1135
550,nekoho,88,58,30,547,701,272
551,deje,87,77,10,559,473,1723
552,technologii,87,81,6,559,435,4187
553,branit,87,80,7,559,442,3258
554,pohrozil,87,83,4,559,422,6257
555,podminky,87,63,24,559,623,422
556,cem,87,56,31,559,737,253
557,reakci,87,71,16,559,533,819
558,neda,87,63,24,559,623,422
559,konfliktu,87,80,7,559,442,3258
560,jinde,87,64,23,559,611,454
561,zmenit,87,58,29,559,701,289
562,vseho,87,58,29,559,701,289
563,cestu,87,66,21,559,582,528
564,pouziti,87,74,13,559,501,1135
565,musel,87,59,28,559,685,309
566,timto,86,65,21,571,596,528
567,francie,86,81,5,571,435,5227
568,stavu,86,74,12,571,501,1282
569,urovni,86,61,25,571,657,390
570,celem,86,79,7,571,451,3258
571,sily,86,68,18,571,563,689
572,casti,86,68,18,571,563,689
573,krize,86,70,16,571,543,819
574,nem,86,62,24,571,639,422
575,dostat,86,56,30,571,737,272
576,vzdycky,85,56,29,581,737,289
577,strane,85,62,23,581,639,454
578,ekonomicky,85,67,18,581,572,689
579,teprve,85,62,23,581,639,454
580,tou,85,59,26,581,685,356
581,pozdeji,85,76,9,581,482,2037
582,slunce,85,62,23,581,639,454
583,hrad,85,72,13,581,521,1135
584,problemu,85,72,13,581,521,1135
585,jediny,84,60,24,590,671,422
586,politicky,84,65,19,590,596,626
587,paliva,84,79,5,590,451,5227
588,jit,84,46,38,590,955,167
589,slovo,84,60,24,590,671,422
590,rizeni,84,61,23,590,657,454
591,zivota,84,57,27,590,718,329
592,evropu,84,70,14,590,543,1009
593,obyvatel,84,60,24,590,671,422
594,cilem,84,78,6,590,462,4187
595,otazku,83,62,21,601,639,528
596,elektrina,83,78,5,601,462,5227
597,uhelne,83,83,0,601,422,49909
598,brat,83,64,19,601,611,626
599,zakladni,83,62,21,601,639,528
600,oproti,83,63,20,601,623,575
601,stovky,83,69,14,601,552,1009
602,spojene,83,70,13,601,543,1135
603,energetiku,83,75,8,601,491,2605
604,stavbe,83,79,4,601,451,6257
605,nekteri,83,62,21,601,639,528
606,osn,83,72,11,601,521,1469
607,generace,82,61,21,615,657,528
608,ruskym,82,71,11,615,533,1469
609,nejspis,82,58,24,615,701,422
610,nikoho,82,51,31,615,832,253
611,zmeny,82,65,17,615,596,754
612,vliv,82,62,20,615,639,575
613,cemu,82,56,26,615,737,356
614,minimalne,82,71,11,615,533,1469
615,velkou,82,64,18,615,611,689
616,vidim,82,48,34,615,898,209
617,zadnou,82,65,17,615,596,754
618,lidstvo,82,68,14,615,563,1009
619,jedne,82,64,18,615,611,689
620,projektu,82,71,11,615,533,1469
621,vedet,82,52,30,615,811,272
622,druhy,82,54,28,615,777,309
623,politici,81,61,20,628,657,575
624,zacne,81,60,21,628,671,528
625,kratkeho,81,65,16,628,596,819
626,mensi,81,64,17,628,611,754
627,existuje,81,61,20,628,657,575
628,kterem,81,60,21,628,671,528
629,pravo,81,68,13,628,563,1135
630,cesko,81,73,8,628,510,2605
631,palivo,81,74,7,628,501,3258
632,zit,80,53,27,638,795,329
633,plati,80,60,20,638,671,575
634,dolaru,80,67,13,638,572,1135
635,pul,80,52,28,638,811,309
636,stane,80,73,7,638,510,3258
637,vytvoreni,80,70,10,638,543,1723
638,stal,80,61,19,638,657,626
639,nejvice,80,58,22,638,701,488
640,zkusenosti,80,71,9,638,533,2037
641,pocet,80,72,8,638,521,2605
642,cesky,80,62,18,638,639,689
643,platit,80,65,15,638,596,904
644,aniz,79,59,20,646,685,575
645,budoucnost,79,62,17,646,639,754
646,nebot,79,57,22,646,718,488
647,rozmistenim,78,72,6,653,521,4187
648,dava,78,69,9,653,552,2037
649,globalni,78,72,6,653,521,4187
650,podporu,78,66,12,653,582,1282
651,patri,78,53,25,653,795,390
652,bezpecnostni,78,68,10,653,563,1723
653,souvislosti,78,62,16,653,639,819
654,mluvi,78,59,19,653,685,626
655,praze,78,43,35,653,1046,198
656,zas,78,52,26,653,811,356
657,dneska,78,49,29,653,870,289
658,cestou,77,51,26,662,832,356
659,hlavice,77,72,5,662,521,5227
660,vedci,77,66,11,662,582,1469
661,pohledu,77,56,21,662,737,528
662,politicke,77,54,23,662,777,454
663,media,77,54,23,662,777,454
664,nikoliv,77,63,14,662,623,1009
665,bomby,76,64,12,673,611,1282
666,obcanu,76,58,18,673,701,689
667,nahodou,76,56,20,673,737,575
668,schopen,76,66,10,673,582,1723
669,myslite,76,54,22,673,777,488
670,udalosti,76,53,23,673,795,454
671,ps,76,38,38,673,1205,167
672,ukrajiny,76,60,16,673,671,819
673,uradu,76,74,2,673,501,10460
674,prostredky,76,65,11,673,596,1469
675,nahradit,76,66,10,673,582,1723
676,auta,76,64,12,673,611,1282
677,ukrajina,76,58,18,673,701,689
678,jadernem,76,66,10,673,582,1723
679,smerem,76,59,17,673,685,754
680,ministryne,76,69,7,673,552,3258
681,more,75,56,19,687,737,626
682,dosud,75,66,9,687,582,2037
683,dni,75,57,18,687,718,689
684,nikde,75,47,28,687,927,309
685,nazory,75,52,23,687,811,454
686,energetika,75,72,3,687,521,7621
687,stavi,75,66,9,687,582,2037
688,temi,75,61,14,687,657,1009
689,prilis,75,56,19,687,737,626
690,teda,75,55,20,687,758,575
691,snaha,75,65,10,687,596,1723
692,hlavy,74,49,25,699,870,390
693,ruskeho,74,60,14,699,671,1009
694,kazdeho,74,57,17,699,718,754
695,rf,74,65,9,699,596,2037
696,akorat,74,57,17,699,718,754
697,ukrajine,74,52,22,699,811,488
698,syrii,74,58,16,699,701,819
699,mir,74,55,19,699,758,626
700,doufam,74,54,20,699,777,575
701,obou,74,62,12,699,639,1282
702,srovnani,74,62,12,699,639,1282
703,zejmena,74,61,13,699,657,1135
704,cesku,74,63,11,699,623,1469
705,pohled,73,46,27,709,955,329
706,ziskat,73,59,14,709,685,1009
707,statniho,73,67,6,709,572,4187
708,zbytecne,73,49,24,709,870,422
709,raji,73,55,18,709,758,689
710,musime,73,56,17,709,737,754
711,zbran,73,60,13,709,671,1135
712,reaktor,72,66,6,721,582,4187
713,skoda,72,51,21,721,832,528
714,jiri,72,47,25,721,927,390
715,skupiny,72,54,18,721,777,689
716,udelal,72,47,25,721,927,390
717,mesta,72,61,11,721,657,1469
718,male,72,60,12,721,671,1282
719,program,72,57,15,721,718,904
720,prohlaseni,72,53,19,721,795,626
721,energetice,72,70,2,721,543,10460
722,dne,72,54,18,721,777,689
723,kdysi,72,62,10,721,639,1723
724,dlouhodobe,72,62,10,721,639,1723
725,nijak,72,55,17,721,758,754
726,kremlu,72,52,20,721,811,575
727,tudiz,72,64,8,721,611,2605
728,ukrajinu,72,51,21,721,832,528
729,americka,71,59,12,735,685,1282
730,mely,71,55,16,735,758,819
731,korun,71,67,4,735,572,6257
732,zacina,71,51,20,735,832,575
733,dusledku,71,54,17,735,777,754
734,armada,71,62,9,735,639,2037
735,zhruba,71,62,9,735,639,2037
736,dulezite,71,52,19,735,811,626
737,rict,71,52,19,735,811,626
738,ukol,71,58,13,735,701,1135
739,site,71,64,7,735,611,3258
740,ruzne,70,52,18,747,811,689
741,minulosti,70,54,16,747,777,819
742,bezpecnosti,70,59,11,747,685,1469
743,naseho,70,58,12,747,701,1282
744,poslednich,70,57,13,747,718,1135
745,prava,70,46,24,747,955,422
746,desitky,70,56,14,747,737,1009
747,zniceni,70,55,15,747,758,904
748,michalsnobr,70,69,1,747,552,20351
749,zajem,70,48,22,747,898,488
750,maly,70,43,27,747,1046,329
751,dokaze,70,42,28,747,1078,309
752,hlavnim,70,63,7,747,623,3258
753,realne,70,56,14,747,737,1009
754,procent,69,57,12,762,718,1282
755,obeti,69,55,14,762,758,1009
756,solarni,69,64,5,762,611,5227
757,hrade,69,65,4,762,596,6257
758,meho,69,51,18,762,832,689
759,nadale,69,47,22,762,927,488
760,rusy,69,59,10,762,685,1723
761,projekt,69,63,6,762,623,4187
762,cili,69,58,11,762,701,1469
763,nedavno,69,45,24,762,989,422
764,rada,69,56,13,762,737,1135
765,pomoc,69,56,13,762,737,1135
766,nesmysl,69,54,15,762,777,904
767,abych,69,44,25,762,1017,390
768,velice,69,56,13,762,737,1135
769,tentokrat,68,50,18,777,852,689
770,takovych,68,49,19,777,870,626
771,miliardy,68,55,13,777,758,1135
772,chapu,68,42,26,777,1078,356
773,nekterych,68,55,13,777,758,1135
774,krymu,68,48,20,777,898,575
775,us,68,59,9,777,685,2037
776,ukazuje,68,56,12,777,737,1282
777,lodi,68,53,15,777,795,904
778,psal,68,43,25,777,1046,390
779,tezko,68,59,9,777,685,2037
780,potrebuje,68,45,23,777,989,454
781,tezke,68,48,20,777,898,575
782,skoly,68,40,28,777,1138,309
783,spolecne,68,49,19,777,870,626
784,jedina,67,49,18,791,870,689
785,okamzite,67,55,12,791,758,1282
786,hlavu,67,41,26,791,1106,356
787,cernobylu,67,62,5,791,639,5227
788,dukovanech,67,66,1,791,582,20351
789,inf,67,62,5,791,639,5227
790,slov,67,41,26,791,1106,356
791,zpet,67,53,14,791,795,1009
792,zivotnost,67,64,3,791,611,7621
793,volbach,67,38,29,791,1205,289
794,zacatku,67,48,19,791,898,626
795,cviceni,67,54,13,791,777,1135
796,dali,67,49,18,791,870,689
797,dodnes,66,51,15,807,832,904
798,poctu,66,51,15,807,832,904
799,narodni,66,49,17,807,870,754
800,dalo,66,45,21,807,989,528
801,budeli,66,65,1,807,596,20351
802,pravdepodobne,66,61,5,807,657,5227
803,ceho,66,54,12,807,777,1282
804,bojovat,66,49,17,807,870,754
805,novakova,66,60,6,807,671,4187
806,uderu,66,55,11,807,758,1469
807,trumpa,66,62,4,807,639,6257
808,nebudu,66,53,13,807,795,1135
809,nemeli,66,51,15,807,832,904
810,historii,66,54,12,807,777,1282
811,driv,66,38,28,807,1205,309
812,moskvy,66,40,26,807,1138,356
813,formou,66,60,6,807,671,4187
814,doba,66,51,15,807,832,904
815,mesice,66,42,24,807,1078,422
816,tym,65,57,8,824,718,2605
817,amici,65,46,19,824,955,626
818,vychode,65,49,16,824,870,819
819,vystavby,65,61,4,824,657,6257
820,letu,65,56,9,824,737,2037
821,zajmu,65,63,2,824,623,10460
822,ceskych,65,58,7,824,701,3258
823,zajmy,65,42,23,824,1078,454
824,politice,65,52,13,824,811,1135
825,zapade,65,46,19,824,955,626
826,zastavit,65,51,14,824,832,1009
827,tyka,65,48,17,824,898,754
828,otazky,65,48,17,824,898,754
829,ministerstvo,65,48,17,824,898,754
830,novou,65,52,13,824,811,1135
831,bures,64,7,57,845,7377,62
832,obe,64,46,18,845,955,689
833,autor,64,54,10,845,777,1723
834,budoucnosti,64,60,4,845,671,6257
835,zakon,64,40,24,845,1138,422
836,vyrobit,64,44,20,845,1017,575
837,mnoha,64,43,21,845,1046,528
838,rocne,64,58,6,845,701,4187
839,najednou,64,53,11,845,795,1469
840,tyden,64,46,18,845,955,689
841,neumi,64,45,19,845,989,626
842,vyroba,64,51,13,845,832,1135
843,britanie,64,60,4,845,671,6257
844,uloziste,64,60,4,845,671,6257
845,ruskou,64,49,15,845,870,904
846,narod,64,38,26,845,1205,356
847,vojaku,64,55,9,845,758,2037
848,umi,64,39,25,845,1173,390
849,zajimave,64,48,16,845,898,819
850,vybuchu,64,53,11,845,795,1469
851,organizace,64,49,15,845,870,904
852,andrej,64,56,8,845,737,2605
853,abychom,64,58,6,845,701,4187
854,predstavit,64,46,18,845,955,689
855,nemela,64,56,8,845,737,2605
856,vysledek,64,45,19,845,989,626
857,hezky,64,40,24,845,1138,422
858,vsechna,64,40,24,845,1138,422
859,pocit,63,43,20,869,1046,575
860,dane,63,44,19,869,1017,626
861,rici,63,51,12,869,832,1282
862,okolo,63,54,9,869,777,2037
863,temelina,63,60,3,869,671,7621
864,zpusob,63,53,10,869,795,1723
865,jednat,63,48,15,869,898,904
866,kc,63,58,5,869,701,5227
867,hranice,63,50,13,869,852,1135
868,jinou,63,45,18,869,989,689
869,hranic,63,51,12,869,832,1282
870,radi,63,47,16,869,927,819
871,cokoliv,63,43,20,869,1046,575
872,dostali,63,46,17,869,955,754
873,soudruzi,63,49,14,869,870,1009
874,vykon,63,57,6,869,718,4187
875,americkeho,63,47,16,869,927,819
876,moskva,63,46,17,869,955,754
877,oci,63,38,25,869,1205,390
878,celeho,62,53,9,887,795,2037
879,jina,62,46,16,887,955,819
880,nechteji,62,46,16,887,955,819
881,urad,62,58,4,887,701,6257
882,petr,62,51,11,887,832,1469
883,museli,62,44,18,887,1017,689
884,ostatne,62,52,10,887,811,1723
885,dojde,62,50,12,887,852,1282
886,setkani,62,45,17,887,989,754
887,mala,62,41,21,887,1106,528
888,dukovan,62,62,0,887,639,49909
889,tyhle,62,40,22,887,1138,488
890,nebezpeci,62,42,20,887,1078,575
891,zaklade,62,51,11,887,832,1469
892,minut,62,48,14,887,898,1009
893,smlouva,62,52,10,887,811,1723
894,vitr,62,48,14,887,898,1009
895,poprve,61,34,27,908,1364,329
896,rozhodovat,61,57,4,908,718,6257
897,denne,61,41,20,908,1106,575
898,podivat,61,42,19,908,1078,626
899,vesmiru,61,54,7,908,777,3258
900,obyvatele,61,47,14,908,927,1009
901,roli,61,48,13,908,898,1135
902,pracovat,61,43,18,908,1046,689
903,vyrabet,61,53,8,908,795,2605
904,okolnosti,61,43,18,908,1046,689
905,prisel,61,39,22,908,1173,488
906,resi,61,56,5,908,737,5227
907,jednim,61,54,7,908,777,3258
908,hranici,61,43,18,908,1046,689
909,elektromobily,61,61,0,908,657,49909
910,utokem,61,54,7,908,777,3258
911,stav,61,50,11,908,852,1469
912,nechapu,61,39,22,908,1173,488
913,konkretne,61,46,15,908,955,904
914,stavba,61,55,6,908,758,4187
915,severni,61,52,9,908,811,2037
916,obecne,61,51,10,908,832,1723
917,podstatne,61,54,7,908,777,3258
918,americti,61,38,23,908,1205,454
919,rade,61,46,15,908,955,904
920,vykonu,60,55,5,931,758,5227
921,zbytek,60,45,15,931,989,904
922,demokracie,60,34,26,931,1364,356
923,valkou,60,49,11,931,870,1469
924,strely,60,56,4,931,737,6257
925,zahranicni,60,48,12,931,898,1282
926,ekonomicke,60,39,21,931,1173,528
927,kazdem,60,38,22,931,1205,488
928,strana,60,37,23,931,1237,454
929,odzbrojovaci,60,59,1,931,685,20351
930,vyse,60,50,10,931,852,1723
931,jednani,60,48,12,931,898,1282
932,moskve,60,46,14,931,955,1009
933,stavby,60,58,2,931,701,10460
934,vsemi,60,45,15,931,989,904
935,izrael,60,58,2,931,701,10460
936,havarie,60,55,5,931,758,5227
937,dobra,60,43,17,931,1046,754
938,pujde,60,43,17,931,1046,754
939,znicit,60,57,3,931,718,7621
940,jehoz,60,48,12,931,898,1282
941,jan,60,44,16,931,1017,819
942,jakou,59,50,9,951,852,2037
943,tematem,59,58,1,951,701,20351
944,mistni,59,41,18,951,1106,689
945,rikam,59,39,20,951,1173,575
946,muzou,59,38,21,951,1205,528
947,riziko,59,56,3,951,737,7621
948,video,59,41,18,951,1106,689
949,sluzby,59,46,13,951,955,1135
950,trhu,59,48,11,951,898,1469
951,premier,59,40,19,951,1138,626
952,ctzive,59,56,3,951,737,7621
953,vetsinu,59,45,14,951,989,1009
954,dluhu,59,57,2,951,718,10460
955,jaka,59,48,11,951,898,1469
956,dostatecne,59,52,7,951,811,3258
957,financni,59,51,8,951,832,2605
958,rekla,59,52,7,951,811,3258
959,iran,58,56,2,970,737,10460
960,mista,58,47,11,970,927,1469
961,dispozici,58,48,10,970,898,1723
962,sanci,58,40,18,970,1138,689
963,letadla,58,47,11,970,927,1469
964,podil,58,54,4,970,777,6257
965,zacali,58,43,15,970,1046,904
966,voda,58,43,15,970,1046,904
967,bezpecne,58,43,15,970,1046,904
968,tajne,58,49,9,970,870,2037
969,cist,58,47,11,970,927,1469
970,tj,58,48,10,970,898,1723
971,pekne,58,42,16,970,1078,819
972,schopny,58,42,16,970,1078,819
973,nechci,58,43,15,970,1046,904
974,vcera,58,41,17,970,1106,754
975,vodu,58,46,12,970,955,1282
976,kazda,58,41,17,970,1106,754
977,zbrojeni,58,57,1,970,718,20351
978,vyrazne,58,44,14,970,1017,1009
979,zabranit,58,50,8,970,852,2605
980,prostrednictvim,57,47,10,993,927,1723
981,smrti,57,40,17,993,1138,754
982,zakladny,57,48,9,993,898,2037
983,planu,57,48,9,993,898,2037
984,verit,57,39,18,993,1173,689
985,vedou,57,45,12,993,989,1282
986,planety,57,47,10,993,927,1723
987,zije,57,45,12,993,989,1282
988,reagovat,57,39,18,993,1173,689
989,ciste,57,50,7,993,852,3258
990,babise,57,34,23,993,1364,454
991,myslel,57,29,28,993,1615,309
992,osobni,57,40,17,993,1138,754
993,planete,57,44,13,993,1017,1135
994,rusaci,57,50,7,993,852,3258
995,nejdrive,57,48,9,993,898,2037
996,politika,57,46,11,993,955,1469
997,prvnim,57,45,12,993,989,1282
998,preci,57,32,25,993,1458,390
999,obnovitelne,57,53,4,993,795,6257
1000,priklad,57,50,7,993,852,3258
1001,rusum,57,40,17,993,1138,754
1002,pripad,57,47,10,993,927,1723
1003,parlamentu,57,45,12,993,989,1282
1004,federace,57,46,11,993,955,1469
1005,lidske,57,44,13,993,1017,1135
1006,zasadni,56,39,17,1017,1173,754
1007,vojaci,56,37,19,1017,1237,626
1008,uroven,56,44,12,1017,1017,1282
1009,cinu,56,44,12,1017,1017,1282
1010,vest,56,43,13,1017,1046,1135
1011,nesouhlasim,56,47,9,1017,927,2037
1012,vystavbe,56,54,2,1017,777,10460
1013,ct,56,43,13,1017,1046,1135
1014,same,56,43,13,1017,1046,1135
1015,proces,56,43,13,1017,1046,1135
1016,uvedl,56,51,5,1017,832,5227
1017,energeticke,56,48,8,1017,898,2605
1018,aneb,56,40,16,1017,1138,819
1019,ruce,56,43,13,1017,1046,1135
1020,udela,56,42,14,1017,1078,1009
1021,zacalo,56,40,16,1017,1138,819
1022,muz,56,36,20,1017,1274,575
1023,nemecke,56,48,8,1017,898,2605
1024,syrie,56,38,18,1017,1205,689
1025,normalni,56,45,11,1017,989,1469
1026,jelikoz,56,46,10,1017,955,1723
1027,relativne,56,48,8,1017,898,2605
1028,uder,55,47,8,1040,927,2605
1029,spojenci,55,49,6,1040,870,4187
1030,zacnou,55,39,16,1040,1173,819
1031,tlaci,55,46,9,1040,955,2037
1032,funguje,55,46,9,1040,955,2037
1033,ohledu,55,50,5,1040,852,5227
1034,budouci,55,45,10,1040,989,1723
1035,obchodu,55,45,10,1040,989,1723
1036,raketach,55,42,13,1040,1078,1135
1037,rusu,55,41,14,1040,1106,1009
1038,nasledky,55,48,7,1040,898,3258
1039,drzi,55,37,18,1040,1237,689
1040,ustavu,55,30,25,1040,1558,390
1041,nejedly,55,51,4,1040,832,6257
1042,vyjadreni,55,44,11,1040,1017,1469
1043,konce,55,48,7,1040,898,3258
1044,jaksi,55,36,19,1040,1274,626
1045,havarii,55,45,10,1040,989,1723
1046,chcipnou,55,45,10,1040,989,1723
1047,jednom,55,34,21,1040,1364,528
1048,rezimu,55,35,20,1040,1316,575
1049,neexistuje,55,51,4,1040,832,6257
1050,schopni,55,44,11,1040,1017,1469
1051,zivote,55,30,25,1040,1558,390
1052,nikomu,54,36,18,1060,1274,689
1053,zavislosti,54,53,1,1060,795,20351
1054,jede,54,37,17,1060,1237,754
1055,rozumi,54,29,25,1060,1615,390
1056,fazi,54,41,13,1060,1106,1135
1057,pomalu,54,43,11,1060,1046,1469
1058,nesmi,54,36,18,1060,1274,689
1059,akce,54,47,7,1060,927,3258
1060,vysvetlit,54,33,21,1060,1415,528
1061,celkove,54,46,8,1060,955,2605
1062,druha,54,44,10,1060,1017,1723
1063,nemohou,54,52,2,1060,811,10460
1064,dotace,54,49,5,1060,870,5227
1065,nejakeho,54,36,18,1060,1274,689
1066,vyvoje,54,43,11,1060,1046,1469
1067,prisli,54,41,13,1060,1106,1135
1068,pochopitelne,53,45,8,1076,989,2605
1069,podminek,53,43,10,1076,1046,1723
1070,vodni,53,47,6,1076,927,4187
1071,soucasti,53,47,6,1076,927,4187
1072,ropy,53,51,2,1076,832,10460
1073,rovnou,53,44,9,1076,1017,2037
1074,nebe,53,37,16,1076,1237,819
1075,konflikt,53,38,15,1076,1205,904
1076,jinym,53,33,20,1076,1415,575
1077,obrovske,53,50,3,1076,852,7621
1078,sit,53,35,18,1076,1316,689
1079,prahy,53,30,23,1076,1558,454
1080,zmenu,53,39,14,1076,1173,1009
1081,vlade,53,45,8,1076,989,2605
1082,mohly,53,49,4,1076,870,6257
1083,lidstva,53,42,11,1076,1078,1469
1084,nizsi,52,35,17,1098,1316,754
1085,predtim,52,38,14,1098,1205,1009
1086,snizeni,52,40,12,1098,1138,1282
1087,naivne,52,51,1,1098,832,20351
1088,vztahu,52,33,19,1098,1415,626
1089,zlo,52,43,9,1098,1046,2037
1090,vadi,52,40,12,1098,1138,1282
1091,nebezpecne,52,37,15,1098,1237,904
1092,tvrde,52,28,24,1098,1693,422
1093,nemohl,52,28,24,1098,1693,422
1094,zacala,52,42,10,1098,1078,1723
1095,leta,52,33,19,1098,1415,626
1096,zivotnosti,52,48,4,1098,898,6257
1097,vojsk,52,31,21,1098,1502,528
1098,utoky,52,48,4,1098,898,6257
1099,provoz,52,48,4,1098,898,6257
1100,namorni,52,42,10,1098,1078,1723
1101,listopadu,52,42,10,1098,1078,1723
1102,rust,52,42,10,1098,1078,1723
1103,stredni,52,35,17,1098,1316,754
1104,prumysl,52,45,7,1098,989,3258
1105,stran,52,30,22,1098,1558,488
1106,zakazku,52,42,10,1098,1078,1723
1107,zbranich,52,51,1,1098,832,20351
1108,vyuzit,52,36,16,1098,1274,819
1109,dny,52,24,28,1098,2030,309
1110,skutecnost,52,45,7,1098,989,3258
1111,stejny,52,41,11,1098,1106,1469
1112,rozpadu,51,49,2,1125,870,10460
1113,mori,51,43,8,1125,1046,2605
1114,miliony,51,45,6,1125,989,4187
1115,francii,51,46,5,1125,955,5227
1116,rovnez,51,41,10,1125,1106,1723
1117,rodina,51,26,25,1125,1846,390
1118,zpravy,51,40,11,1125,1138,1469
1119,pristich,51,47,4,1125,927,6257
1120,republice,51,37,14,1125,1237,1009
1121,zeleni,51,48,3,1125,898,7621
1122,tez,51,33,18,1125,1415,689
1123,dostala,51,37,14,1125,1237,1009
1124,cimz,51,45,6,1125,989,4187
1125,plan,51,46,5,1125,955,5227
1126,rozpoctu,51,41,10,1125,1106,1723
1127,zivotni,51,35,16,1125,1316,819
1128,logicky,51,37,14,1125,1237,1009
1129,rezim,51,35,16,1125,1316,819
1130,zari,51,35,16,1125,1316,819
1131,tenhle,51,34,17,1125,1364,754
1132,obavy,51,42,9,1125,1078,2037
1133,voleb,51,21,30,1125,2372,272
1134,odkud,51,35,16,1125,1316,819
1135,musim,51,35,16,1125,1316,819
1136,sujb,51,51,0,1125,832,49909
1137,elektrarne,51,48,3,1125,898,7621
1138,vyrobe,50,42,8,1154,1078,2605
1139,pristi,50,33,17,1154,1415,754
1140,udelali,50,40,10,1154,1138,1723
1141,lidska,50,35,15,1154,1316,904
1142,snadno,50,35,15,1154,1316,904
1143,zmrdi,50,50,0,1154,852,49909
1144,psat,50,29,21,1154,1615,528
1145,otazkou,50,42,8,1154,1078,2605
1146,poradku,50,36,14,1154,1274,1009
1147,prispevku,50,32,18,1154,1458,689
1148,rusti,50,34,16,1154,1364,819
1149,stala,50,37,13,1154,1237,1135
1150,vetrne,50,46,4,1154,955,6257
1151,svetu,50,41,9,1154,1106,2037
1152,mesic,50,33,17,1154,1415,754
1153,musite,50,34,16,1154,1364,819
1154,zemich,50,41,9,1154,1106,2037
1155,vojensky,50,45,5,1154,989,5227
1156,expertni,50,50,0,1154,852,49909
1157,zprava,50,33,17,1154,1415,754
1158,spoustu,50,40,10,1154,1138,1723
1159,klimatu,50,47,3,1154,927,7621
1160,obcas,50,33,17,1154,1415,754
1161,postavi,50,47,3,1154,927,7621
1162,investice,50,41,9,1154,1106,2037
1163,dum,50,41,9,1154,1106,2037
1164,boj,50,42,8,1154,1078,2605
1165,chyba,50,22,28,1154,2257,309
1166,vyrabi,50,43,7,1154,1046,3258
1167,toz,50,40,10,1154,1138,1723
1168,svetovou,50,39,11,1154,1173,1469
1169,dalsiho,49,44,5,1180,1017,5227
1170,existuji,49,34,15,1180,1364,904
1171,najit,49,25,24,1180,1927,422
1172,oficialne,49,38,11,1180,1205,1469
1173,spojenych,49,43,6,1180,1046,4187
1174,rano,49,33,16,1180,1415,819
1175,zvlastni,49,26,23,1180,1846,454
1176,jakehosi,49,47,2,1180,927,10460
1177,materialu,49,42,7,1180,1078,3258
1178,mnozi,49,25,24,1180,1927,422
1179,praha,49,34,15,1180,1364,904
1180,moderni,49,47,2,1180,927,10460
1181,krym,49,43,6,1180,1046,4187
1182,opilci,49,45,4,1180,989,6257
1183,hlavic,49,48,1,1180,898,20351
1184,cetl,49,34,15,1180,1364,904
1185,aut,49,40,9,1180,1138,2037
1186,postupne,49,44,5,1180,1017,5227
1187,polsku,49,41,8,1180,1106,2605
1188,prostor,49,45,4,1180,989,6257
1189,podporil,49,49,0,1180,870,49909
1190,kazdopadne,49,34,15,1180,1364,904
1191,iranu,48,41,7,1209,1106,3258
1192,nejvic,48,28,20,1209,1693,575
1193,vyuziti,48,35,13,1209,1316,1135
1194,rus,48,43,5,1209,1046,5227
1195,case,48,40,8,1209,1138,2605
1196,radiacni,48,43,5,1209,1046,5227
1197,velikost,48,27,21,1209,1776,528
1198,nevidel,48,30,18,1209,1558,689
1199,cesi,48,36,12,1209,1274,1282
1200,rosatomu,48,46,2,1209,955,10460
1201,zdaleka,48,31,17,1209,1502,754
1202,cernobyl,48,43,5,1209,1046,5227
1203,rozmisteni,48,40,8,1209,1138,2605
1204,pokani,48,32,16,1209,1458,819
1205,vybuch,48,34,14,1209,1364,1009
1206,nesmysly,48,39,9,1209,1173,2037
1207,velmoci,48,45,3,1209,989,7621
1208,produkce,48,39,9,1209,1173,2037
1209,nestalo,48,36,12,1209,1274,1282
1210,zle,48,28,20,1209,1693,575
1211,odbornici,48,37,11,1209,1237,1469
1212,nechat,48,40,8,1209,1138,2605
1213,nekomu,48,34,14,1209,1364,1009
1214,vysoke,48,36,12,1209,1274,1282
1215,siti,48,36,12,1209,1274,1282
1216,dodal,48,42,6,1209,1078,4187
1217,smyslu,48,33,15,1209,1415,904
1218,zvysit,48,31,17,1209,1502,754
1219,lzi,48,32,16,1209,1458,819
1220,sef,48,38,10,1209,1205,1723
1221,likvidace,48,35,13,1209,1316,1135
1222,new,48,37,11,1209,1237,1469
1223,hodi,48,26,22,1209,1846,488
1224,elektrarnach,48,48,0,1209,898,49909
1225,podobe,48,41,7,1209,1106,3258
1226,radon,47,33,14,1239,1415,1009
1227,pozice,47,33,14,1239,1415,1009
1228,slovy,47,28,19,1239,1693,626
1229,zadnem,47,31,16,1239,1502,819
1230,pochopit,47,37,10,1239,1237,1723
1231,nevysli,47,45,2,1239,989,10460
1232,proudu,47,38,9,1239,1205,2037
1233,vlastnim,47,33,14,1239,1415,1009
1234,vedel,47,24,23,1239,2030,454
1235,potreby,47,36,11,1239,1274,1469
1236,zvyseni,47,34,13,1239,1364,1135
1237,pouziva,47,43,4,1239,1046,6257
1238,radiu,47,47,0,1239,927,49909
1239,programu,47,41,6,1239,1106,4187
1240,nicemu,47,28,19,1239,1693,626
1241,takovym,47,34,13,1239,1364,1135
1242,cinnosti,47,39,8,1239,1173,2605
1243,ukrajinske,47,30,17,1239,1558,754
1244,dalsim,47,39,8,1239,1173,2605
1245,sic,47,46,1,1239,955,20351
1246,brzy,47,27,20,1239,1776,575
1247,ponekud,47,37,10,1239,1237,1723
1248,znamo,47,35,12,1239,1316,1282
1249,historie,47,43,4,1239,1046,6257
1250,dovolit,47,34,13,1239,1364,1135
1251,vyroci,47,33,14,1239,1415,1009
1252,zruseni,46,30,16,1275,1558,819
1253,pozici,46,36,10,1275,1274,1723
1254,jednotky,46,35,11,1275,1316,1469
1255,operaci,46,38,8,1275,1205,2605
1256,rikat,46,26,20,1275,1846,575
1257,financovani,46,37,9,1275,1237,2037
1258,pocitat,46,40,6,1275,1138,4187
1259,fungovat,46,32,14,1275,1458,1009
1260,muzes,46,28,18,1275,1693,689
1261,akci,46,35,11,1275,1316,1469
1262,doporucuji,46,39,7,1275,1173,3258
1263,veskere,46,39,7,1275,1173,3258
1264,cnn,46,46,0,1275,955,49909
1265,emise,46,44,2,1275,1017,10460
1266,lidskych,46,38,8,1275,1205,2605
1267,tun,46,43,3,1275,1046,7621
1268,desitek,46,40,6,1275,1138,4187
1269,svetova,46,41,5,1275,1106,5227
1270,mld,46,42,4,1275,1078,6257
1271,the,46,35,11,1275,1316,1469
1272,jednoznacne,46,43,3,1275,1046,7621
1273,drabove,46,35,11,1275,1316,1469
1274,dodat,46,40,6,1275,1138,4187
1275,ambice,46,39,7,1275,1173,3258
1276,prani,46,23,23,1275,2144,454
1277,prostoru,46,37,9,1275,1237,2037
1278,trh,46,39,7,1275,1173,3258
1279,tanky,46,38,8,1275,1205,2605
1280,archavt,46,46,0,1275,955,49909
1281,zalezi,46,39,7,1275,1173,3258
1282,neznamena,46,28,18,1275,1693,689
1283,ptejme,46,46,0,1275,955,49909
1284,prestoze,46,40,6,1275,1138,4187
1285,westinghouse,46,44,2,1275,1017,10460
1286,auto,46,36,10,1275,1274,1723
1287,romove,46,45,1,1275,989,20351
1288,radioaktivniho,46,42,4,1275,1078,6257
1289,historicky,46,27,19,1275,1776,626
1290,prime,46,27,19,1275,1776,626
1291,ceka,46,32,14,1275,1458,1009
1292,vychodni,46,39,7,1275,1173,3258
1293,spolecneho,46,37,9,1275,1237,2037
1294,demokracii,46,26,20,1275,1846,575
1295,pruplavu,46,46,0,1275,955,49909
1296,stejnou,46,33,13,1275,1415,1135
1297,pomerne,45,29,16,1313,1615,819
1298,cekat,45,26,19,1313,1846,626
1299,nerozumi,45,39,6,1313,1173,4187
1300,cisla,45,37,8,1313,1237,2605
1301,fajn,45,29,16,1313,1615,819
1302,pondeli,45,33,12,1313,1415,1282
1303,tvori,45,33,12,1313,1415,1282
1304,jejim,45,36,9,1313,1274,2037
1305,pokracovat,45,41,4,1313,1106,6257
1306,procesu,45,34,11,1313,1364,1469
1307,jakych,45,36,9,1313,1274,2037
1308,drazdi,45,45,0,1313,989,49909
1309,pricemz,45,34,11,1313,1364,1469
1310,ekonomiky,45,39,6,1313,1173,4187
1311,dostane,45,26,19,1313,1846,626
1312,zvlaste,45,39,6,1313,1173,4187
1313,obriho,45,45,0,1313,989,49909
1314,rizika,45,37,8,1313,1237,2605
1315,kazdou,45,39,6,1313,1173,4187
1316,cezu,45,41,4,1313,1106,6257
1317,kamuflovano,45,45,0,1313,989,49909
1318,rikaji,45,33,12,1313,1415,1282
1319,bizarnim,45,45,0,1313,989,49909
1320,alexandrmitrofa,45,43,2,1313,1046,10460
1321,agresori,45,35,10,1313,1316,1723
1322,prezidentem,45,41,4,1313,1106,6257
1323,vystavba,45,44,1,1313,1017,20351
1324,neskakejme,45,45,0,1313,989,49909
1325,niceni,45,44,1,1313,1017,20351
1326,byvaly,45,32,13,1313,1458,1135
1327,zemanovi,45,35,10,1313,1316,1723
1328,cine,44,37,7,1346,1237,3258
1329,radost,44,24,20,1346,2030,575
1330,nejakych,44,37,7,1346,1237,3258
1331,vondracek,44,29,15,1346,1615,904
1332,clanky,44,30,14,1346,1558,1009
1333,vedi,44,37,7,1346,1237,3258
1334,navrh,44,25,19,1346,1927,626
1335,velkych,44,34,10,1346,1364,1723
1336,tvrzeni,44,35,9,1346,1316,2037
1337,vysoce,44,39,5,1346,1173,5227
1338,meste,44,30,14,1346,1558,1009
1339,mluvil,44,37,7,1346,1237,3258
1340,cechach,44,40,4,1346,1138,6257
1341,buh,44,34,10,1346,1364,1723
1342,pouzije,44,42,2,1346,1078,10460
1343,trva,44,30,14,1346,1558,1009
1344,zato,44,28,16,1346,1693,819
1345,prispevek,44,34,10,1346,1364,1723
1346,rozumne,44,38,6,1346,1205,4187
1347,pole,44,33,11,1346,1415,1469
1348,amerika,44,40,4,1346,1138,6257
1349,podivejte,44,36,8,1346,1274,2605
1350,martin,44,42,2,1346,1078,10460
1351,dohodu,44,37,7,1346,1237,3258
1352,stacilo,44,28,16,1346,1693,819
1353,neslo,44,25,19,1346,1927,626
1354,nikoli,44,31,13,1346,1502,1135
1355,scenar,44,40,4,1346,1138,6257
1356,jizni,44,35,9,1346,1316,2037
1357,verejneho,44,34,10,1346,1364,1723
1358,niz,44,35,9,1346,1316,2037
1359,noci,44,31,13,1346,1502,1135
1360,druhu,44,38,6,1346,1205,4187
1361,delsi,44,40,4,1346,1138,6257
1362,souvisi,44,26,18,1346,1846,689
1363,drahou,43,38,5,1383,1205,5227
1364,tito,43,28,15,1383,1693,904
1365,prachy,43,31,12,1383,1502,1282
1366,pouzivaji,43,34,9,1383,1364,2037
1367,zivotu,43,33,10,1383,1415,1723
1368,hledat,43,30,13,1383,1558,1135
1369,vyhrozuje,43,41,2,1383,1106,10460
1370,pravidelne,43,28,15,1383,1693,904
1371,siri,43,33,10,1383,1415,1723
1372,totez,43,30,13,1383,1558,1135
1373,projekty,43,37,6,1383,1237,4187
1374,silou,43,38,5,1383,1205,5227
1375,afghanistanu,43,33,10,1383,1415,1723
1376,rozhodl,43,33,10,1383,1415,1723
1377,uhelnych,43,41,2,1383,1106,10460
1378,vedomi,43,33,10,1383,1415,1723
1379,medii,43,40,3,1383,1138,7621
1380,apod,43,38,5,1383,1205,5227
1381,ministra,43,35,8,1383,1316,2605
1382,zjevne,43,28,15,1383,1693,904
1383,dvakrat,43,28,15,1383,1693,904
1384,raketami,43,38,5,1383,1205,5227
1385,hlasu,43,22,21,1383,2257,528
1386,stava,43,30,13,1383,1558,1135
1387,duchu,43,18,25,1383,2788,390
1388,dotaci,43,37,6,1383,1237,4187
1389,myslenky,43,25,18,1383,1927,689
1390,ctvrtek,43,30,13,1383,1558,1135
1391,veku,43,26,17,1383,1846,754
1392,doslova,43,29,14,1383,1615,1009
1393,emisi,43,39,4,1383,1173,6257
1394,skonci,43,31,12,1383,1502,1282
1395,nechal,43,32,11,1383,1458,1469
1396,natolik,43,25,18,1383,1927,689
1397,washingtonu,43,33,10,1383,1415,1723
1398,iraku,43,36,7,1383,1274,3258
1399,hraje,43,35,8,1383,1316,2605
1400,odkaz,43,33,10,1383,1415,1723
1401,soucasnosti,43,39,4,1383,1173,6257
1402,dochazi,42,33,9,1428,1415,2037
1403,mesicu,42,35,7,1428,1316,3258
1404,vitezstvi,42,20,22,1428,2502,488
1405,vyzkumu,42,37,5,1428,1237,5227
1406,krok,42,29,13,1428,1615,1135
1407,vyzkum,42,35,7,1428,1316,3258
1408,zeptat,42,29,13,1428,1615,1135
1409,metru,42,38,4,1428,1205,6257
1410,jakym,42,25,17,1428,1927,754
1411,vojenskou,42,34,8,1428,1364,2605
1412,prvnich,42,36,6,1428,1274,4187
1413,reakce,42,30,12,1428,1558,1282
1414,hodnoty,42,36,6,1428,1274,4187
1415,systemy,42,42,0,1428,1078,49909
1416,ucelem,42,33,9,1428,1415,2037
1417,zrusit,42,31,11,1428,1502,1469
1418,tlak,42,31,11,1428,1502,1469
1419,telo,42,31,11,1428,1502,1469
1420,vlastnich,42,31,11,1428,1502,1469
1421,zalezitosti,42,28,14,1428,1693,1009
1422,vysoky,42,31,11,1428,1502,1469
1423,lip,42,20,22,1428,2502,488
1424,potrebuji,42,34,8,1428,1364,2605
1425,politicka,42,36,6,1428,1274,4187
1426,civilizace,42,34,8,1428,1364,2605
1427,povazuje,42,38,4,1428,1205,6257
1428,mistech,42,26,16,1428,1846,819
1429,vzniku,42,39,3,1428,1173,7621
1430,nemecky,42,33,9,1428,1415,2037
1431,plany,42,27,15,1428,1776,904
1432,druheho,42,31,11,1428,1502,1469
1433,pristup,42,39,3,1428,1173,7621
1434,obcane,42,20,22,1428,2502,488
1435,jinymi,42,28,14,1428,1693,1009
1436,vztahy,42,36,6,1428,1274,4187
1437,pozornost,42,34,8,1428,1364,2605
1438,sakra,42,31,11,1428,1502,1469
1439,prodlouzeni,42,40,2,1428,1138,10460
1440,vratit,42,30,12,1428,1558,1282
1441,ministerstva,42,33,9,1428,1415,2037
1442,chybi,42,21,21,1428,2372,528
1443,nejlepe,42,31,11,1428,1502,1469
1444,volebni,42,15,27,1428,3369,329
1445,mohu,42,30,12,1428,1558,1282
1446,tvrdit,42,31,11,1428,1502,1469
1447,fb,42,41,1,1428,1106,20351
1448,gorbacov,42,30,12,1428,1558,1282
1449,oba,42,26,16,1428,1846,819
1450,cil,42,39,3,1428,1173,7621
1451,chysta,42,27,15,1428,1776,904
1452,dlouhe,42,27,15,1428,1776,904
1453,oznamil,42,28,14,1428,1693,1009
1454,operace,41,31,10,1472,1502,1723
1455,strasne,41,22,19,1472,2257,626
1456,agrese,41,40,1,1472,1138,20351
1457,armadu,41,38,3,1472,1205,7621
1458,vypovezeni,41,26,15,1472,1846,904
1459,rakousko,41,35,6,1472,1316,4187
1460,spotreby,41,37,4,1472,1237,6257
1461,nepritele,41,28,13,1472,1693,1135
1462,zni,41,35,6,1472,1316,4187
1463,poradne,41,25,16,1472,1927,819
1464,uvedomit,41,28,13,1472,1693,1135
1465,nastesti,41,31,10,1472,1502,1723
1466,rukou,41,31,10,1472,1502,1723
1467,migrantu,41,36,5,1472,1274,5227
1468,bezne,41,32,9,1472,1458,2037
1469,zakona,41,19,22,1472,2644,488
1470,napadeni,41,34,7,1472,1364,3258
1471,agresor,41,31,10,1472,1502,1723
1472,kteremu,41,31,10,1472,1502,1723
1473,muselo,41,33,8,1472,1415,2605
1474,ok,41,27,14,1472,1776,1009
1475,internetu,41,32,9,1472,1458,2037
1476,ekonomika,41,35,6,1472,1316,4187
1477,zakony,41,25,16,1472,1927,819
1478,levnejsi,41,36,5,1472,1274,5227
1479,min,41,34,7,1472,1364,3258
1480,dvema,41,34,7,1472,1364,3258
1481,jasny,41,29,12,1472,1615,1282
1482,davat,41,29,12,1472,1615,1282
1483,obvykle,41,34,7,1472,1364,3258
1484,argument,41,29,12,1472,1615,1282
1485,narody,41,34,7,1472,1364,3258
1486,ochranu,41,35,6,1472,1316,4187
1487,otevrene,41,37,4,1472,1237,6257
1488,verim,41,30,11,1472,1558,1469
1489,skupina,41,36,5,1472,1274,5227
1490,naivni,40,30,10,1511,1558,1723
1491,reci,40,29,11,1511,1615,1469
1492,nenavisti,40,16,24,1511,3148,422
1493,skvele,40,21,19,1511,2372,626
1494,zaplati,40,37,3,1511,1237,7621
1495,vis,40,19,21,1511,2644,528
1496,spolupraci,40,37,3,1511,1237,7621
1497,tahle,40,27,13,1511,1776,1135
1498,vychazi,40,35,5,1511,1316,5227
1499,nahlasit,40,39,1,1511,1173,20351
1500,zena,40,27,13,1511,1776,1135
1501,objevi,40,31,9,1511,1502,2037
1502,podarilo,40,29,11,1511,1615,1469
1503,zisk,40,27,13,1511,1776,1135
1504,pouzitim,40,40,0,1511,1138,49909
1505,stary,40,22,18,1511,2257,689
1506,top,40,18,22,1511,2788,488
1507,atomove,40,39,1,1511,1173,20351
1508,skody,40,28,12,1511,1693,1282
1509,zime,40,34,6,1511,1364,4187
1510,britove,40,35,5,1511,1316,5227
1511,narodu,40,36,4,1511,1274,6257
1512,teoreticky,40,35,5,1511,1316,5227
1513,vzit,40,28,12,1511,1693,1282
1514,maximalne,40,30,10,1511,1558,1723
1515,ziji,40,37,3,1511,1237,7621
1516,dohromady,40,32,8,1511,1458,2605
1517,rozhovoru,40,36,4,1511,1274,6257
1518,prijit,40,33,7,1511,1415,3258
1519,evropskych,40,36,4,1511,1274,6257
1520,poruseni,40,36,4,1511,1274,6257
1521,ztraty,40,38,2,1511,1205,10460
1522,diskuzi,40,32,8,1511,1458,2605
1523,nasim,40,33,7,1511,1415,3258
1524,omezeni,40,33,7,1511,1415,3258
1525,predchozi,40,34,6,1511,1364,4187
1526,vysledky,40,30,10,1511,1558,1723
1527,de,40,30,10,1511,1558,1723
1528,odpovedi,40,30,10,1511,1558,1723
1529,nasledujici,40,35,5,1511,1316,5227
1530,cen,40,24,16,1511,2030,819
1531,oblast,40,32,8,1511,1458,2605
1532,zavislost,39,36,3,1561,1274,7621
1533,nekolikrat,39,28,11,1561,1693,1469
1534,rozum,39,27,12,1561,1776,1282
1535,zapadnich,39,29,10,1561,1615,1723
1536,zivoty,39,22,17,1561,2257,754
1537,republika,39,28,11,1561,1693,1469
1538,chemicke,39,34,5,1561,1364,5227
1539,nezavislost,39,33,6,1561,1415,4187
1540,zitra,39,24,15,1561,2030,904
1541,zeny,39,24,15,1561,2030,904
1542,silu,39,31,8,1561,1502,2605
1543,ruku,39,27,12,1561,1776,1282
1544,vojenska,39,39,0,1561,1173,49909
1545,revoluce,39,21,18,1561,2372,689
1546,nesmyslne,39,26,13,1561,1846,1135
1547,nejakym,39,33,6,1561,1415,4187
1548,obranu,39,31,8,1561,1502,2605
1549,nest,39,37,2,1561,1237,10460
1550,ropu,39,35,4,1561,1316,6257
1551,expert,39,30,9,1561,1558,2037
1552,jdou,39,29,10,1561,1615,1723
1553,el,39,32,7,1561,1458,3258
1554,svemu,39,31,8,1561,1502,2605
1555,zajistit,39,36,3,1561,1274,7621
1556,mych,39,25,14,1561,1927,1009
1557,funkci,39,23,16,1561,2144,819
1558,vychod,39,35,4,1561,1316,6257
1559,vecne,39,32,7,1561,1458,3258
1560,drzet,39,23,16,1561,2144,819
1561,konvencni,39,35,4,1561,1316,6257
1562,kilometru,39,36,3,1561,1274,7621
1563,specialni,39,30,9,1561,1558,2037
1564,dojit,39,30,9,1561,1558,2037
1565,dodavky,39,27,12,1561,1776,1282
1566,politickych,39,26,13,1561,1846,1135
1567,typ,39,34,5,1561,1364,5227
1568,zmeni,39,26,13,1561,1846,1135
1569,letos,39,31,8,1561,1502,2605
1570,dohoda,39,32,7,1561,1458,3258
1571,strach,39,30,9,1561,1558,2037
1572,vyplyva,39,33,6,1561,1415,4187
1573,trvat,39,28,11,1561,1693,1469
1574,ekologicke,39,36,3,1561,1274,7621
1575,udrzet,39,28,11,1561,1693,1469
1576,existenci,39,34,5,1561,1364,5227
1577,drahe,39,39,0,1561,1173,49909
1578,americkou,39,30,9,1561,1558,2037
1579,diskuze,39,27,12,1561,1776,1282
1580,fyziky,39,25,14,1561,1927,1009
1581,prijdou,39,20,19,1561,2502,626
1582,kanal,39,35,4,1561,1316,6257
1583,snahu,39,38,1,1561,1205,20351
1584,elektromobilu,39,37,2,1561,1237,10460
1585,aktualni,39,34,5,1561,1364,5227
1586,soud,39,28,11,1561,1693,1469
1587,skrze,39,36,3,1561,1274,7621
1588,super,39,27,12,1561,1776,1282
1589,zname,39,28,11,1561,1693,1469
1590,republiku,38,27,11,1613,1776,1469
1591,hospodarstvi,38,23,15,1613,2144,904
1592,mucednici,38,28,10,1613,1693,1723
1593,tanku,38,26,12,1613,1846,1282
1594,dodavat,38,34,4,1613,1364,6257
1595,probiha,38,30,8,1613,1558,2605
1596,ukrajinska,38,22,16,1613,2257,819
1597,musela,38,31,7,1613,1502,3258
1598,britanii,38,31,7,1613,1502,3258
1599,pravidla,38,19,19,1613,2644,626
1600,pocatku,38,27,11,1613,1776,1469
1601,mw,38,33,5,1613,1415,5227
1602,opakovane,38,35,3,1613,1316,7621
1603,oficialni,38,33,5,1613,1415,5227
1604,poradce,38,28,10,1613,1693,1723
1605,tsunami,38,30,8,1613,1558,2605
1606,varovani,38,31,7,1613,1502,3258
1607,vysledku,38,29,9,1613,1615,2037
1608,umele,38,23,15,1613,2144,904
1609,zony,38,22,16,1613,2257,819
1610,radsi,38,20,18,1613,2502,689
1611,tezby,38,38,0,1613,1205,49909
1612,cizi,38,27,11,1613,1776,1469
1613,centralni,38,23,15,1613,2144,904
1614,vysvetleni,38,28,10,1613,1693,1723
1615,model,38,25,13,1613,1927,1135
1616,tenkrat,38,24,14,1613,2030,1009
1617,mnohe,38,25,13,1613,1927,1135
1618,zakonu,38,28,10,1613,1693,1723
1619,technicky,38,35,3,1613,1316,7621
1620,vidite,38,25,13,1613,1927,1135
1621,studene,38,33,5,1613,1415,5227
1622,ucast,38,20,18,1613,2502,689
1623,modelu,38,30,8,1613,1558,2605
1624,potrebujeme,38,31,7,1613,1502,3258
1625,provest,38,36,2,1613,1274,10460
1626,minuly,38,20,18,1613,2502,689
1627,podpora,38,30,8,1613,1558,2605
1628,odmitl,38,34,4,1613,1364,6257
1629,levne,38,28,10,1613,1693,1723
1630,putinem,38,28,10,1613,1693,1723
1631,velkem,38,29,9,1613,1615,2037
1632,precist,38,29,9,1613,1615,2037
1633,krasne,38,23,15,1613,2144,904
1634,patrne,38,19,19,1613,2644,626
1635,soucasna,37,24,13,1665,2030,1135
1636,resp,37,31,6,1665,1502,4187
1637,pripomina,37,25,12,1665,1927,1282
1638,temeline,37,37,0,1665,1237,49909
1639,sankci,37,22,15,1665,2257,904
1640,informacni,37,25,12,1665,1927,1282
1641,televizi,37,25,12,1665,1927,1282
1642,nekam,37,24,13,1665,2030,1135
1643,rychlosti,37,32,5,1665,1458,5227
1644,kus,37,25,12,1665,1927,1282
1645,fve,37,28,9,1665,1693,2037
1646,vzajemne,37,35,2,1665,1316,10460
1647,socialni,37,23,14,1665,2144,1009
1648,pokus,37,20,17,1665,2502,754
1649,uvidime,37,29,8,1665,1615,2605
1650,pripravuji,37,30,7,1665,1558,3258
1651,dulezity,37,21,16,1665,2372,819
1652,okamziku,37,29,8,1665,1615,2605
1653,tomhle,37,23,14,1665,2144,1009
1654,chtela,37,25,12,1665,1927,1282
1655,vidime,37,26,11,1665,1846,1469
1656,tomuto,37,28,9,1665,1693,2037
1657,chovat,37,17,20,1665,2956,575
1658,cesty,37,34,3,1665,1364,7621
1659,vzdelani,37,24,13,1665,2030,1135
1660,latky,37,25,12,1665,1927,1282
1661,bruselu,37,22,15,1665,2257,904
1662,konkretni,37,24,13,1665,2030,1135
1663,fuze,37,36,1,1665,1274,20351
1664,politik,37,24,13,1665,2030,1135
1665,zbrojni,37,30,7,1665,1558,3258
1666,absolutne,37,28,9,1665,1693,2037
1667,plus,37,25,12,1665,1927,1282
1668,plny,37,20,17,1665,2502,754
1669,raketovy,37,31,6,1665,1502,4187
1670,vaseho,37,22,15,1665,2257,904
1671,pamatuji,37,24,13,1665,2030,1135
1672,nedostatek,37,32,5,1665,1458,5227
1673,predsedkyne,37,35,2,1665,1316,10460
1674,klidu,37,26,11,1665,1846,1469
1675,pracuje,37,30,7,1665,1558,3258
1676,opatreni,37,34,3,1665,1364,7621
1677,cinou,37,28,9,1665,1693,2037
1678,vyvoji,37,37,0,1665,1237,49909
1679,odbornik,37,30,7,1665,1558,3258
1680,bohatstvi,37,28,9,1665,1693,2037
1681,rozvoj,37,34,3,1665,1364,7621
1682,paks,37,36,1,1665,1274,20351
1683,neuveritelne,37,26,11,1665,1846,1469
1684,zdravi,37,31,6,1665,1502,4187
1685,dani,37,21,16,1665,2372,819
1686,tuhle,37,22,15,1665,2257,904
1687,zkuste,37,26,11,1665,1846,1469
1688,natoz,37,25,12,1665,1927,1282
1689,ucit,37,19,18,1665,2644,689
1690,knihy,37,17,20,1665,2956,575
1691,nejsme,37,34,3,1665,1364,7621
1692,nichz,37,24,13,1665,2030,1135
1693,baterie,37,35,2,1665,1316,10460
1694,smrt,37,29,8,1665,1615,2605
1695,mocnosti,36,32,4,1724,1458,6257
1696,material,36,31,5,1724,1502,5227
1697,puvodne,36,28,8,1724,1693,2605
1698,dam,36,14,22,1724,3621,488
1699,prectete,36,29,7,1724,1615,3258
1700,mozneho,36,24,12,1724,2030,1282
1701,schopnosti,36,28,8,1724,1693,2605
1702,praxi,36,34,2,1724,1364,10460
1703,lidmi,36,25,11,1724,1927,1469
1704,bomba,36,26,10,1724,1846,1723
1705,katastrofy,36,31,5,1724,1502,5227
1706,nasem,36,29,7,1724,1615,3258
1707,masivni,36,30,6,1724,1558,4187
1708,veri,36,29,7,1724,1615,3258
1709,momentalne,36,31,5,1724,1502,5227
1710,dopravni,36,23,13,1724,2144,1135
1711,sledovat,36,26,10,1724,1846,1723
1712,politickou,36,28,8,1724,1693,2605
1713,informoval,36,21,15,1724,2372,904
1714,limity,36,34,2,1724,1364,10460
1715,armade,36,30,6,1724,1558,4187
1716,chovani,36,22,14,1724,2257,1009
1717,preventivni,36,35,1,1724,1316,20351
1718,pouzijeme,36,36,0,1724,1274,49909
1719,vladu,36,33,3,1724,1415,7621
1720,pevne,36,28,8,1724,1693,2605
1721,jednoduche,36,27,9,1724,1776,2037
1722,hlavici,36,33,3,1724,1415,7621
1723,ohrozeni,36,35,1,1724,1316,20351
1724,prostredku,36,28,8,1724,1693,2605
1725,povedlo,36,32,4,1724,1458,6257
1726,cert,36,32,4,1724,1458,6257
1727,ponorky,36,33,3,1724,1415,7621
1728,ukrajinsky,36,21,15,1724,2372,904
1729,rustu,36,20,16,1724,2502,819
1730,vyznam,36,25,11,1724,1927,1469
1731,drazsi,36,34,2,1724,1364,10460
1732,vybaveni,36,26,10,1724,1846,1723
1733,nadeji,36,26,10,1724,1846,1723
1734,snemovny,36,20,16,1724,2502,819
1735,vmesovani,36,21,15,1724,2372,904
1736,ceskou,36,28,8,1724,1693,2605
1737,prozatim,36,32,4,1724,1458,6257
1738,castecne,36,28,8,1724,1693,2605
1739,pripada,36,28,8,1724,1693,2605
1740,pozitivni,36,28,8,1724,1693,2605
1741,ocividne,36,24,12,1724,2030,1282
1742,slyset,36,28,8,1724,1693,2605
1743,rekneme,36,24,12,1724,2030,1282
1744,zastupce,36,21,15,1724,2372,904
1745,jmenem,36,24,12,1724,2030,1282
1746,vs,36,25,11,1724,1927,1469
1747,skole,36,23,13,1724,2144,1135
1748,putinova,36,31,5,1724,1502,5227
1749,ziskani,36,32,4,1724,1458,6257
1750,agresivni,36,31,5,1724,1502,5227
1751,jisty,36,23,13,1724,2144,1135
1752,pisete,36,14,22,1724,3621,488
1753,donbasu,35,19,16,1784,2644,819
1754,tela,35,24,11,1784,2030,1469
1755,domaci,35,27,8,1784,1776,2605
1756,uranu,35,31,4,1784,1502,6257
1757,vodou,35,24,11,1784,2030,1469
1758,vzduchu,35,26,9,1784,1846,2037
1759,cerne,35,20,15,1784,2502,904
1760,miri,35,31,4,1784,1502,6257
1761,novym,35,21,14,1784,2372,1009
1762,dosahnout,35,31,4,1784,1502,6257
1763,casem,35,32,3,1784,1458,7621
1764,prichazi,35,16,19,1784,3148,626
1765,stare,35,27,8,1784,1776,2605
1766,potencial,35,30,5,1784,1558,5227
1767,vidi,35,33,2,1784,1415,10460
1768,ptat,35,23,12,1784,2144,1282
1769,milos,35,28,7,1784,1693,3258
1770,novicok,35,20,15,1784,2502,904
1771,vyznamne,35,29,6,1784,1615,4187
1772,abys,35,17,18,1784,2956,689
1773,zmene,35,29,6,1784,1615,4187
1774,podminkach,35,28,7,1784,1693,3258
1775,obcany,35,25,10,1784,1927,1723
1776,nemluve,35,31,4,1784,1502,6257
1777,polska,35,27,8,1784,1776,2605
1778,polsko,35,29,6,1784,1615,4187
1779,furt,35,24,11,1784,2030,1469
1780,kontextu,35,26,9,1784,1846,2037
1781,radioaktivity,35,27,8,1784,1776,2605
1782,katastrofa,35,33,2,1784,1415,10460
1783,slouzi,35,27,8,1784,1776,2605
1784,ukazalo,35,31,4,1784,1502,6257
1785,myslis,35,22,13,1784,2257,1135
1786,poradu,35,23,12,1784,2144,1282
1787,bombu,35,32,3,1784,1458,7621
1788,tridy,35,26,9,1784,1846,2037
1789,fyzik,35,13,22,1784,3915,488
1790,napsat,35,22,13,1784,2257,1135
1791,zacatek,35,27,8,1784,1776,2605
1792,zachovani,35,28,7,1784,1693,3258
1793,kldr,35,33,2,1784,1415,10460
1794,trpi,35,20,15,1784,2502,904
1795,peti,35,28,7,1784,1693,3258
1796,obyvatelstvo,35,23,12,1784,2144,1282
1797,americkym,35,28,7,1784,1693,3258
1798,nepritel,35,28,7,1784,1693,3258
1799,volicu,35,9,26,1784,5739,356
1800,nemeni,35,21,14,1784,2372,1009
1801,ucasti,35,15,20,1784,3369,575
1802,napeti,35,29,6,1784,1615,4187
1803,existence,35,34,1,1784,1364,20351
1804,predseda,35,16,19,1784,3148,626
1805,rodiny,35,19,16,1784,2644,819
1806,chemickych,35,27,8,1784,1776,2605
1807,kterymi,35,16,19,1784,3148,626
1808,potrebu,35,24,11,1784,2030,1469
1809,rise,35,23,12,1784,2144,1282
1810,spousta,35,26,9,1784,1846,2037
1811,kroky,35,32,3,1784,1458,7621
1812,cssd,35,18,17,1784,2788,754
1813,schopna,35,28,7,1784,1693,3258
1814,financi,34,27,7,1844,1776,3258
1815,kg,34,24,10,1844,2030,1723
1816,lode,34,32,2,1844,1458,10460
1817,zkratka,34,25,9,1844,1927,2037
1818,general,34,26,8,1844,1846,2605
1819,firma,34,27,7,1844,1776,3258
1820,porusuje,34,29,5,1844,1615,5227
1821,meni,34,29,5,1844,1615,5227
1822,rozhovor,34,29,5,1844,1615,5227
1823,neceho,34,22,12,1844,2257,1282
1824,znamy,34,23,11,1844,2144,1469
1825,narazil,34,28,6,1844,1693,4187
1826,odporu,34,33,1,1844,1415,20351
1827,nehrozi,34,27,7,1844,1776,3258
1828,rozporu,34,29,5,1844,1615,5227
1829,hodnot,34,32,2,1844,1458,10460
1830,firem,34,32,2,1844,1458,10460
1831,velikosti,34,30,4,1844,1558,6257
1832,pouzivat,34,28,6,1844,1693,4187
1833,bojuje,34,27,7,1844,1776,3258
1834,bavime,34,29,5,1844,1615,5227
1835,potrebovat,34,21,13,1844,2372,1135
1836,gw,34,31,3,1844,1502,7621
1837,realita,34,27,7,1844,1776,3258
1838,vybral,34,31,3,1844,1502,7621
1839,kdosi,34,27,7,1844,1776,3258
1840,neverim,34,23,11,1844,2144,1469
1841,medaili,34,34,0,1844,1364,49909
1842,nevedel,34,20,14,1844,2502,1009
1843,odpovednost,34,19,15,1844,2644,904
1844,kdybys,34,15,19,1844,3369,626
1845,prednost,34,30,4,1844,1558,6257
1846,pocita,34,29,5,1844,1615,5227
1847,chodi,34,24,10,1844,2030,1723
1848,touto,34,28,6,1844,1693,4187
1849,ostatnich,34,30,4,1844,1558,6257
1850,abyste,34,21,13,1844,2372,1135
1851,zapadem,34,19,15,1844,2644,904
1852,novem,34,24,10,1844,2030,1723
1853,delo,34,22,12,1844,2257,1282
1854,vzali,34,16,18,1844,3148,689
1855,nesmime,34,31,3,1844,1502,7621
1856,zpatky,34,22,12,1844,2257,1282
1857,dostavba,34,34,0,1844,1364,49909
1858,uspesne,34,28,6,1844,1693,4187
1859,normalne,34,26,8,1844,1846,2605
1860,dostavbe,34,33,1,1844,1415,20351
1861,ponorek,34,31,3,1844,1502,7621
1862,fyziku,34,13,21,1844,3915,528
1863,tematu,34,25,9,1844,1927,2037
1864,nerekl,34,23,11,1844,2144,1469
1865,aktualne,34,29,5,1844,1615,5227
1866,dostatek,34,19,15,1844,2644,904
1867,ba,34,22,12,1844,2257,1282
1868,indie,34,32,2,1844,1458,10460
1869,ridi,34,28,6,1844,1693,4187
1870,prodlouzit,34,33,1,1844,1415,20351
1871,vojenskych,34,32,2,1844,1458,10460
1872,letadel,34,24,10,1844,2030,1723
1873,volici,34,7,27,1844,7377,329
1874,vytvari,33,28,5,1909,1693,5227
1875,zem,33,22,11,1909,2257,1469
1876,kapitalismu,33,19,14,1909,2644,1009
1877,jez,33,27,6,1909,1776,4187
1878,duse,33,17,16,1909,2956,819
1879,krizi,33,22,11,1909,2257,1469
1880,jejichz,33,27,6,1909,1776,4187
1881,kyjev,33,23,10,1909,2144,1723
1882,technicke,33,30,3,1909,1558,7621
1883,policie,33,25,8,1909,1927,2605
1884,jednoduse,33,26,7,1909,1846,3258
1885,rikal,33,24,9,1909,2030,2037
1886,vlivu,33,28,5,1909,1693,5227
1887,kaliningradu,33,28,5,1909,1693,5227
1888,obnovitelnych,33,28,5,1909,1693,5227
1889,americanum,33,27,6,1909,1776,4187
1890,povazuji,33,21,12,1909,2372,1282
1891,obyvatelstva,33,28,5,1909,1693,5227
1892,ochrany,33,30,3,1909,1558,7621
1893,tunel,33,30,3,1909,1558,7621
1894,elektricke,33,32,1,1909,1458,20351
1895,tvrda,33,23,10,1909,2144,1723
1896,tydnu,33,20,13,1909,2502,1135
1897,pujdou,33,30,3,1909,1558,7621
1898,vysoka,33,27,6,1909,1776,4187
1899,jedineho,33,28,5,1909,1693,5227
1900,libi,33,18,15,1909,2788,904
1901,raje,33,33,0,1909,1415,49909
1902,hinkley,33,32,1,1909,1458,20351
1903,novinare,33,15,18,1909,3369,689
1904,absolutni,33,23,10,1909,2144,1723
1905,evidentne,33,19,14,1909,2644,1009
1906,majetku,33,26,7,1909,1846,3258
1907,nachazi,33,24,9,1909,2030,2037
1908,nemohu,33,22,11,1909,2257,1469
1909,diskuse,33,23,10,1909,2144,1723
1910,pruser,33,22,11,1909,2257,1469
1911,cislo,33,24,9,1909,2030,2037
1912,hrozba,33,29,4,1909,1615,6257
1913,sila,33,29,4,1909,1615,6257
1914,prahu,33,17,16,1909,2956,819
1915,zakazky,33,29,4,1909,1615,6257
1916,nasili,33,17,16,1909,2956,819
1917,schopne,33,31,2,1909,1502,10460
1918,saudske,33,20,13,1909,2502,1135
1919,jaderni,33,21,12,1909,2372,1282
1920,diskusi,33,24,9,1909,2030,2037
1921,souhlas,33,24,9,1909,2030,2037
1922,mladi,33,15,18,1909,3369,689
1923,patek,33,22,11,1909,2257,1469
1924,stabilni,33,31,2,1909,1502,10460
1925,verzi,33,30,3,1909,1558,7621
1926,stali,33,13,20,1909,3915,575
1927,staly,33,32,1,1909,1458,20351
1928,pobalti,33,26,7,1909,1846,3258
1929,pripravuje,33,29,4,1909,1615,6257
1930,vzdalenosti,33,26,7,1909,1846,3258
1931,hrozbou,33,29,4,1909,1615,6257
1932,nevite,33,19,14,1909,2644,1009
1933,nemecti,33,31,2,1909,1502,10460
1934,pocasi,33,27,6,1909,1776,4187
1935,cinnost,33,28,5,1909,1693,5227
1936,dany,33,17,16,1909,2956,819
1937,neho,33,22,11,1909,2257,1469
1938,oznacil,33,17,16,1909,2956,819
1939,hranicich,33,24,9,1909,2030,2037
1940,nehlede,33,27,6,1909,1776,4187
1941,propaganda,33,21,12,1909,2372,1282
1942,nejmene,33,31,2,1909,1502,10460
1943,parlament,33,12,21,1909,4264,528
1944,kvalita,32,25,7,1976,1927,3258
1945,hranicim,32,24,8,1976,2030,2605
1946,prisla,32,23,9,1976,2144,2037
1947,zdrojem,32,29,3,1976,1615,7621
1948,stacit,32,29,3,1976,1615,7621
1949,nejdulezitejsi,32,28,4,1976,1693,6257
1950,nejblizsi,32,23,9,1976,2144,2037
1951,prospech,32,28,4,1976,1693,6257
1952,roste,32,21,11,1976,2372,1469
1953,nuklearnich,32,30,2,1976,1558,10460
1954,kyjeve,32,16,16,1976,3148,819
1955,hitler,32,24,8,1976,2030,2605
1956,vladni,32,23,9,1976,2144,2037
1957,statem,32,26,6,1976,1846,4187
1958,velkym,32,24,8,1976,2030,2605
1959,arabie,32,20,12,1976,2502,1282
1960,znacne,32,30,2,1976,1558,10460
1961,povoleni,32,28,4,1976,1693,6257
1962,delali,32,20,12,1976,2502,1282
1963,pokracuje,32,24,8,1976,2030,2605
1964,chybu,32,20,12,1976,2502,1282
1965,britske,32,26,6,1976,1846,4187
1966,dalsimi,32,24,8,1976,2030,2605
1967,premierem,32,28,4,1976,1693,6257
1968,radioaktivita,32,27,5,1976,1776,5227
1969,sovetsky,32,23,9,1976,2144,2037
1970,mysleni,32,26,6,1976,1846,4187
1971,tradicni,32,17,15,1976,2956,904
1972,muzu,32,22,10,1976,2257,1723
1973,dostavby,32,30,2,1976,1558,10460
1974,nemelo,32,28,4,1976,1693,6257
1975,radioaktivnim,32,26,6,1976,1846,4187
1976,vazaly,32,32,0,1976,1458,49909
1977,ii,32,27,5,1976,1776,5227
1978,dukazy,32,23,9,1976,2144,2037
1979,nejhorsi,32,21,11,1976,2372,1469
1980,budoucnu,32,29,3,1976,1615,7621
1981,oteplovani,32,30,2,1976,1558,10460
1982,pavel,32,22,10,1976,2257,1723
1983,washington,32,23,9,1976,2144,2037
1984,zadost,32,24,8,1976,2030,2605
1985,zajimalo,32,29,3,1976,1615,7621
1986,avsak,32,23,9,1976,2144,2037
1987,vsim,32,22,10,1976,2257,1723
1988,menit,32,18,14,1976,2788,1009
1989,mereni,32,29,3,1976,1615,7621
1990,stejneho,32,23,9,1976,2144,2037
1991,zil,32,18,14,1976,2788,1009
1992,nechtel,32,14,18,1976,3621,689
1993,vysvetlovat,32,18,14,1976,2788,1009
1994,aktivne,32,25,7,1976,1927,3258
1995,atomovych,32,23,9,1976,2144,2037
1996,centra,32,23,9,1976,2144,2037
1997,podniku,32,25,7,1976,1927,3258
1998,dokument,32,25,7,1976,1927,3258
1999,skoncime,32,22,10,1976,2257,1723
2000,donalda,32,29,3,1976,1615,7621
2001,jakmile,32,24,8,1976,2030,2605
2002,holt,32,24,8,1976,2030,2605
2003,ceskeho,32,23,9,1976,2144,2037
2004,parametry,32,20,12,1976,2502,1282
2005,post,32,28,4,1976,1693,6257
2006,stredu,32,27,5,1976,1776,5227
2007,strel,31,28,3,2051,1693,7621
2008,ekonomice,31,24,7,2051,2030,3258
2009,predpokladam,31,28,3,2051,1693,7621
2010,obri,31,24,7,2051,2030,3258
2011,komentare,31,21,10,2051,2372,1723
2012,uderem,31,24,7,2051,2030,3258
2013,lidskou,31,17,14,2051,2956,1009
2014,realny,31,20,11,2051,2502,1469
2015,obnovit,31,30,1,2051,1558,20351
2016,efektivni,31,30,1,2051,1558,20351
2017,kontrolou,31,17,14,2051,2956,1009
2018,lid,31,24,7,2051,2030,3258
2019,velkeho,31,25,6,2051,1927,4187
2020,dopredu,31,28,3,2051,1693,7621
2021,bomb,31,23,8,2051,2144,2605
2022,funkce,31,16,15,2051,3148,904
2023,koupit,31,26,5,2051,1846,5227
2024,rozsireni,31,26,5,2051,1846,5227
2025,nemozne,31,19,12,2051,2644,1282
2026,spojenymi,31,20,11,2051,2502,1469
2027,babisovi,31,19,12,2051,2644,1282
2028,uprostred,31,16,15,2051,3148,904
2029,stranou,31,18,13,2051,2788,1135
2030,protesty,31,28,3,2051,1693,7621
2031,ceste,31,24,7,2051,2030,3258
2032,podniky,31,20,11,2051,2502,1469
2033,severnich,31,29,2,2051,1615,10460
2034,tvrdil,31,21,10,2051,2372,1723
2035,bordel,31,20,11,2051,2502,1469
2036,jmeno,31,21,10,2051,2372,1723
2037,slysel,31,18,13,2051,2788,1135
2038,nejakem,31,19,12,2051,2644,1282
2039,studii,31,21,10,2051,2372,1723
2040,radonu,31,30,1,2051,1558,20351
2041,fakta,31,25,6,2051,1927,4187
2042,popsal,31,16,15,2051,3148,904
2043,vytvorit,31,21,10,2051,2372,1723
2044,dolu,31,20,11,2051,2502,1469
2045,cene,31,29,2,2051,1615,10460
2046,lod,31,22,9,2051,2257,2037
2047,odzbrojeni,31,28,3,2051,1693,7621
2048,porusovani,31,20,11,2051,2502,1469
2049,httppictwittercomzmtaxhis,31,31,0,2051,1502,49909
2050,cini,31,28,3,2051,1693,7621
2051,dari,31,16,15,2051,3148,904
2052,pryc,31,21,10,2051,2372,1723
2053,vladimira,31,25,6,2051,1927,4187
2054,zakazat,31,31,0,2051,1502,49909
2055,zlikvidovat,31,28,3,2051,1693,7621
2056,cilu,31,23,8,2051,2144,2605
2057,agresi,31,30,1,2051,1558,20351
2058,odvetneho,31,25,6,2051,1927,4187
2059,nemusim,31,20,11,2051,2502,1469
2060,munici,31,24,7,2051,2030,3258
2061,kecy,31,19,12,2051,2644,1282
2062,nohy,31,19,12,2051,2644,1282
2063,principu,31,26,5,2051,1846,5227
2064,pohybuje,31,25,6,2051,1927,4187
2065,nedaleko,31,22,9,2051,2257,2037
2066,sluzeb,31,24,7,2051,2030,3258
2067,predstavitele,31,26,5,2051,1846,5227
2068,priroda,31,28,3,2051,1693,7621
2069,stejni,31,11,20,2051,4658,575
2070,izraeli,31,23,8,2051,2144,2605
2071,vetru,31,26,5,2051,1846,5227
2072,bat,31,18,13,2051,2788,1135
2073,zustava,31,18,13,2051,2788,1135
2074,dostanou,31,23,8,2051,2144,2605
2075,clenove,31,17,14,2051,2956,1009
2076,priblizne,31,30,1,2051,1558,20351
2077,srdce,31,20,11,2051,2502,1469
2078,mem,31,15,16,2051,3369,819
2079,zemanem,31,25,6,2051,1927,4187
2080,teorie,31,26,5,2051,1846,5227
2081,rokem,31,25,6,2051,1927,4187
2082,agentu,31,27,4,2051,1776,6257
2083,termin,31,17,14,2051,2956,1009
2084,znalosti,31,24,7,2051,2030,3258
2085,vsemu,31,19,12,2051,2644,1282
2086,li,31,28,3,2051,1693,7621
2087,budovani,31,28,3,2051,1693,7621
2088,odpovedet,31,23,8,2051,2144,2605
2089,svetlo,31,14,17,2051,3621,754
2090,uvnitr,31,26,5,2051,1846,5227
2091,zakaz,31,27,4,2051,1776,6257
2092,minimalni,31,21,10,2051,2372,1723
2093,vstupu,31,21,10,2051,2372,1723
2094,vyrobni,30,24,6,2132,2030,4187
2095,svedomi,30,18,12,2132,2788,1282
2096,raketove,30,25,5,2132,1927,5227
2097,vyjadrovat,30,15,15,2132,3369,904
2098,jedinou,30,23,7,2132,2144,3258
2099,plochou,30,25,5,2132,1927,5227
2100,ac,30,24,6,2132,2030,4187
2101,cekal,30,15,15,2132,3369,904
2102,vyrobou,30,20,10,2132,2502,1723
2103,ukrajinci,30,22,8,2132,2257,2605
2104,stavajici,30,27,3,2132,1776,7621
2105,cile,30,24,6,2132,2030,4187
2106,zjistit,30,26,4,2132,1846,6257
2107,reknu,30,7,23,2132,7377,454
2108,hnuti,30,17,13,2132,2956,1135
2109,americe,30,28,2,2132,1693,10460
2110,uplny,30,12,18,2132,4264,689
2111,napsala,30,15,15,2132,3369,904
2112,prezit,30,25,5,2132,1927,5227
2113,byvaleho,30,27,3,2132,1776,7621
2114,energetickou,30,25,5,2132,1927,5227
2115,starsi,30,15,15,2132,3369,904
2116,pripraveni,30,28,2,2132,1693,10460
2117,ocich,30,15,15,2132,3369,904
2118,socialismus,30,18,12,2132,2788,1282
2119,znamenalo,30,29,1,2132,1615,20351
2120,americani,30,24,6,2132,2030,4187
2121,starych,30,18,12,2132,2788,1282
2122,smeru,30,26,4,2132,1846,6257
2123,dite,30,16,14,2132,3148,1009
2124,takovem,30,26,4,2132,1846,6257
2125,mesto,30,22,8,2132,2257,2605
2126,klid,30,24,6,2132,2030,4187
2127,spotreba,30,25,5,2132,1927,5227
2128,ameriky,30,27,3,2132,1776,7621
2129,max,30,25,5,2132,1927,5227
2130,pozor,30,22,8,2132,2257,2605
2131,nemas,30,20,10,2132,2502,1723
2132,dala,30,13,17,2132,3915,754
2133,vetsine,30,17,13,2132,2956,1135
2134,zajima,30,27,3,2132,1776,7621
2135,spatny,30,24,6,2132,2030,4187
2136,nemeckych,30,21,9,2132,2372,2037
2137,jidla,30,15,15,2132,3369,904
2138,munice,30,18,12,2132,2788,1282
2139,kdekoliv,30,20,10,2132,2502,1723
2140,argumenty,30,26,4,2132,1846,6257
2141,krve,30,20,10,2132,2502,1723
2142,blizi,30,25,5,2132,1927,5227
2143,cech,30,24,6,2132,2030,4187
2144,proud,30,20,10,2132,2502,1723
2145,nepatri,30,23,7,2132,2144,3258
2146,silnice,30,23,7,2132,2144,3258
2147,kazdemu,30,28,2,2132,1693,10460
2148,ukazat,30,25,5,2132,1927,5227
2149,zvlast,30,25,5,2132,1927,5227
2150,jakekoliv,30,25,5,2132,1927,5227
2151,ovlada,30,29,1,2132,1615,20351
2152,proboha,30,17,13,2132,2956,1135
2153,niceho,30,20,10,2132,2502,1723
2154,soudruh,30,12,18,2132,4264,689
2155,textu,30,27,3,2132,1776,7621
2156,cssr,30,24,6,2132,2030,4187
2157,komentar,30,21,9,2132,2372,2037
2158,prechod,30,21,9,2132,2372,2037
2159,kdybych,30,13,17,2132,3915,754
2160,marie,30,23,7,2132,2144,3258
2161,souladu,30,28,2,2132,1693,10460
2162,trest,30,17,13,2132,2956,1135
2163,konference,30,16,14,2132,3148,1009
2164,bile,30,18,12,2132,2788,1282
2165,komuniste,30,16,14,2132,3148,1009
2166,naroda,30,19,11,2132,2644,1469
2167,komunisti,30,12,18,2132,4264,689
2168,pokrok,30,25,5,2132,1927,5227
2169,nepratele,30,28,2,2132,1693,10460
2170,kdybyste,29,17,12,2217,2956,1282
2171,nasel,29,25,4,2217,1927,6257
2172,hrat,29,19,10,2217,2644,1723
2173,silnejsi,29,22,7,2217,2257,3258
2174,nasazeni,29,23,6,2217,2144,4187
2175,uctu,29,19,10,2217,2644,1723
2176,daji,29,23,6,2217,2144,4187
2177,zelene,29,26,3,2217,1846,7621
2178,zamerne,29,25,4,2217,1927,6257
2179,sla,29,23,6,2217,2144,4187
2180,zdroji,29,29,0,2217,1615,49909
2181,rozsirovat,29,29,0,2217,1615,49909
2182,odlozit,29,28,1,2217,1693,20351
2183,migracni,29,28,1,2217,1693,20351
2184,mluvim,29,20,9,2217,2502,2037
2185,obci,29,24,5,2217,2030,5227
2186,unie,29,23,6,2217,2144,4187
2187,mladych,29,16,13,2217,3148,1135
2188,hospodarky,29,29,0,2217,1615,49909
2189,kuzi,29,13,16,2217,3915,819
2190,vzoru,29,27,2,2217,1776,10460
2191,nuclear,29,28,1,2217,1693,20351
2192,vysetrovani,29,21,8,2217,2372,2605
2193,cestiny,29,25,4,2217,1927,6257
2194,sa,29,22,7,2217,2257,3258
2195,vzal,29,20,9,2217,2502,2037
2196,izraele,29,27,2,2217,1776,10460
2197,reditel,29,16,13,2217,3148,1135
2198,urovne,29,20,9,2217,2502,2037
2199,matky,29,19,10,2217,2644,1723
2200,hodiny,29,25,4,2217,1927,6257
2201,jakubjanda,29,29,0,2217,1615,49909
2202,doposud,29,23,6,2217,2144,4187
2203,malem,29,17,12,2217,2956,1282
2204,via,29,28,1,2217,1693,20351
2205,dopadne,29,24,5,2217,2030,5227
2206,dopad,29,26,3,2217,1846,7621
2207,studie,29,29,0,2217,1615,49909
2208,vezeni,29,22,7,2217,2257,3258
2209,madarsky,29,20,9,2217,2502,2037
2210,spusteni,29,23,6,2217,2144,4187
2211,jednotlivych,29,23,6,2217,2144,4187
2212,tepelne,29,27,2,2217,1776,10460
2213,objevil,29,22,7,2217,2257,3258
2214,velmoc,29,24,5,2217,2030,5227
2215,rekni,29,20,9,2217,2502,2037
2216,energeticka,29,25,4,2217,1927,6257
2217,jist,29,25,4,2217,1927,6257
2218,vasich,29,15,14,2217,3369,1009
2219,valecne,29,26,3,2217,1846,7621
2220,snemovne,29,23,6,2217,2144,4187
2221,zacaly,29,19,10,2217,2644,1723
2222,komentoval,29,15,14,2217,3369,1009
2223,ekonomiku,29,25,4,2217,1927,6257
2224,nelibi,29,22,7,2217,2257,3258
2225,fuzi,29,28,1,2217,1693,20351
2226,hovno,29,14,15,2217,3621,904
2227,jinem,29,20,9,2217,2502,2037
2228,mwh,29,25,4,2217,1927,6257
2229,totalni,29,18,11,2217,2788,1469
2230,nemeckem,29,24,5,2217,2030,5227
2231,musis,29,12,17,2217,4264,754
2232,tlaku,29,21,8,2217,2372,2605
2233,tlakem,29,25,4,2217,1927,6257
2234,mostu,29,16,13,2217,3148,1135
2235,spojit,29,27,2,2217,1776,10460
2236,budoucna,29,19,10,2217,2644,1723
2237,iii,29,21,8,2217,2372,2605
2238,oblastech,29,27,2,2217,1776,10460
2239,nebudeme,29,26,3,2217,1846,7621
2240,hele,29,14,15,2217,3621,904
2241,postavili,29,23,6,2217,2144,4187
2242,prelozeno,29,29,0,2217,1615,49909
2243,potazmo,29,23,6,2217,2144,4187
2244,blbosti,29,20,9,2217,2502,2037
2245,blbost,29,20,9,2217,2502,2037
2246,poslednim,29,21,8,2217,2372,2605
2247,agent,29,19,10,2217,2644,1723
2248,prvniho,29,26,3,2217,1846,7621
2249,zuby,29,15,14,2217,3369,1009
2250,poslanci,29,27,2,2217,1776,10460
2251,odvetu,29,27,2,2217,1776,10460
2252,opakuje,29,21,8,2217,2372,2605
2253,zustane,29,21,8,2217,2372,2605
2254,porovnani,29,16,13,2217,3148,1135
2255,pavla,29,27,2,2217,1776,10460
2256,policii,29,19,10,2217,2644,1723
2257,radioaktivnich,29,25,4,2217,1927,6257
2258,pirati,29,7,22,2217,7377,488
2259,zemrel,29,25,4,2217,1927,6257
2260,ostre,29,19,10,2217,2644,1723
2261,pozadi,29,16,13,2217,3148,1135
2262,provadi,29,25,4,2217,1927,6257
2263,americany,29,25,4,2217,1927,6257
2264,informuje,28,17,11,2309,2956,1469
2265,stavebni,28,26,2,2309,1846,10460
2266,of,28,18,10,2309,2788,1723
2267,putinovi,28,25,3,2309,1927,7621
2268,experti,28,21,7,2309,2372,3258
2269,vyviji,28,23,5,2309,2144,5227
2270,nedokazali,28,12,16,2309,4264,819
2271,vyvijet,28,27,1,2309,1776,20351
2272,webu,28,21,7,2309,2372,3258
2273,zdarma,28,20,8,2309,2502,2605
2274,vlaku,28,19,9,2309,2644,2037
2275,socialnich,28,20,8,2309,2502,2605
2276,motor,28,22,6,2309,2257,4187
2277,chlazeni,28,28,0,2309,1693,49909
2278,jakysi,28,15,13,2309,3369,1135
2279,prezidentmluvci,28,27,1,2309,1776,20351
2280,pripadu,28,20,8,2309,2502,2605
2281,vojaky,28,25,3,2309,1927,7621
2282,zustala,28,14,14,2309,3621,1009
2283,obema,28,16,12,2309,3148,1282
2284,hitlera,28,17,11,2309,2956,1469
2285,pomeru,28,18,10,2309,2788,1723
2286,dokazal,28,24,4,2309,2030,6257
2287,regionu,28,21,7,2309,2372,3258
2288,testy,28,23,5,2309,2144,5227
2289,pohon,28,28,0,2309,1693,49909
2290,napad,28,16,12,2309,3148,1282
2291,tricet,28,19,9,2309,2644,2037
2292,donbas,28,15,13,2309,3369,1135
2293,kvalitni,28,17,11,2309,2956,1469
2294,zarenim,28,28,0,2309,1693,49909
2295,techniky,28,25,3,2309,1927,7621
2296,nutno,28,18,10,2309,2788,1723
2297,funkcni,28,24,4,2309,2030,6257
2298,kostce,28,28,0,2309,1693,49909
2299,tveho,28,13,15,2309,3915,904
2300,temito,28,26,2,2309,1846,10460
2301,vyjadril,28,21,7,2309,2372,3258
2302,lokalni,28,27,1,2309,1776,20351
2303,receno,28,22,6,2309,2257,4187
2304,urady,28,24,4,2309,2030,6257
2305,rusaky,28,23,5,2309,2144,5227
2306,nakladu,28,23,5,2309,2144,5227
2307,strategii,28,23,5,2309,2144,5227
2308,postoj,28,21,7,2309,2372,3258
2309,hlave,28,22,6,2309,2257,4187
2310,motoru,28,28,0,2309,1693,49909
2311,pracovni,28,17,11,2309,2956,1469
2312,potencialni,28,22,6,2309,2257,4187
2313,list,28,23,5,2309,2144,5227
2314,vojenskeho,28,20,8,2309,2502,2605
2315,dobrovolne,28,26,2,2309,1846,10460
2316,italie,28,24,4,2309,2030,6257
2317,turecko,28,25,3,2309,1927,7621
2318,mozny,28,24,4,2309,2030,6257
2319,zamer,28,23,5,2309,2144,5227
2320,httpswwwrespektczspolecnostnovakovahradstriktnetrvanastavbejadernychblokualemeneukoluje,28,27,1,2309,1776,20351
2321,odpovedel,28,18,10,2309,2788,1723
2322,kym,28,21,7,2309,2372,3258
2323,dejinach,28,19,9,2309,2644,2037
2324,navzdory,28,18,10,2309,2788,1723
2325,boje,28,25,3,2309,1927,7621
2326,odpovi,28,20,8,2309,2502,2605
2327,teorii,28,22,6,2309,2257,4187
2328,zkusit,28,17,11,2309,2956,1469
2329,stroje,28,24,4,2309,2030,6257
2330,vysvetlili,28,23,5,2309,2144,5227
2331,prirodni,28,25,3,2309,1927,7621
2332,prikladu,28,19,9,2309,2644,2037
2333,planetu,28,24,4,2309,2030,6257
2334,nastane,28,27,1,2309,1776,20351
2335,jejiho,28,26,2,2309,1846,10460
2336,ranni,28,24,4,2309,2030,6257
2337,automobilu,28,20,8,2309,2502,2605
2338,vedenim,28,22,6,2309,2257,4187
2339,mezitim,28,27,1,2309,1776,20351
2340,spalovaci,28,28,0,2309,1693,49909
2341,prve,28,19,9,2309,2644,2037
2342,ukrajinou,28,20,8,2309,2502,2605
2343,puvodu,28,17,11,2309,2956,1469
2344,mozno,28,25,3,2309,1927,7621
2345,pisi,28,23,5,2309,2144,5227
2346,dalnice,28,26,2,2309,1846,10460
2347,vlivem,28,19,9,2309,2644,2037
2348,tydny,28,20,8,2309,2502,2605
2349,budovat,28,25,3,2309,1927,7621
2350,totalne,28,23,5,2309,2144,5227
2351,jedu,28,20,8,2309,2502,2605
2352,fukusime,28,27,1,2309,1776,20351
2353,aliance,28,24,4,2309,2030,6257
2354,rodin,27,16,11,2411,3148,1469
2355,prirode,27,25,2,2411,1927,10460
2356,nemuzeme,27,24,3,2411,2030,7621
2357,logiku,27,24,3,2411,2030,7621
2358,state,27,17,10,2411,2956,1723
2359,rozvedky,27,22,5,2411,2257,5227
2360,kreml,27,21,6,2411,2372,4187
2361,skolstvi,27,13,14,2411,3915,1009
2362,domy,27,17,10,2411,2956,1723
2363,cenou,27,25,2,2411,1927,10460
2364,dulezita,27,23,4,2411,2144,6257
2365,obcanske,27,14,13,2411,3621,1135
2366,text,27,20,7,2411,2502,3258
2367,komunistu,27,13,14,2411,3915,1009
2368,prilezitost,27,9,18,2411,5739,689
2369,letadlo,27,22,5,2411,2257,5227
2370,madarsko,27,17,10,2411,2956,1723
2371,prevahu,27,19,8,2411,2644,2605
2372,slibil,27,20,7,2411,2502,3258
2373,lez,27,22,5,2411,2257,5227
2374,zajimavy,27,22,5,2411,2257,5227
2375,obamovi,27,23,4,2411,2144,6257
2376,tezky,27,16,11,2411,3148,1469
2377,tvari,27,13,14,2411,3915,1009
2378,velitel,27,17,10,2411,2956,1723
2379,kraji,27,15,12,2411,3369,1282
2380,puvodni,27,23,4,2411,2144,6257
2381,cleny,27,24,3,2411,2030,7621
2382,madarska,27,24,3,2411,2030,7621
2383,oboji,27,6,21,2411,8574,528
2384,planuji,27,21,6,2411,2372,4187
2385,pekla,27,22,5,2411,2257,5227
2386,radar,27,22,5,2411,2257,5227
2387,pokazde,27,18,9,2411,2788,2037
2388,podrobnosti,27,19,8,2411,2644,2605
2389,vyrok,27,21,6,2411,2372,4187
2390,porusuji,27,25,2,2411,1927,10460
2391,hur,27,15,12,2411,3369,1282
2392,jednak,27,18,9,2411,2788,2037
2393,nasilne,27,14,13,2411,3621,1135
2394,kratsi,27,19,8,2411,2644,2605
2395,skupinacez,27,26,1,2411,1846,20351
2396,svobodu,27,15,12,2411,3369,1282
2397,zbyva,27,23,4,2411,2144,6257
2398,balisticke,27,24,3,2411,2030,7621
2399,ctete,27,23,4,2411,2144,6257
2400,klubu,27,19,8,2411,2644,2605
2401,naproste,27,16,11,2411,3148,1469
2402,tehle,27,22,5,2411,2257,5227
2403,zapomnel,27,15,12,2411,3369,1282
2404,malych,27,17,10,2411,2956,1723
2405,obrovskou,27,26,1,2411,1846,20351
2406,zrusil,27,16,11,2411,3148,1469
2407,desetileti,27,25,2,2411,1927,10460
2408,arzenal,27,27,0,2411,1776,49909
2409,skutecny,27,24,3,2411,2030,7621
2410,ekonomickou,27,22,5,2411,2257,5227
2411,zmen,27,25,2,2411,1927,10460
2412,zivych,27,26,1,2411,1846,20351
2413,prilezitosti,27,22,5,2411,2257,5227
2414,strategickych,27,23,4,2411,2144,6257
2415,hloupost,27,12,15,2411,4264,904
2416,coby,27,16,11,2411,3148,1469
2417,dobach,27,19,8,2411,2644,2605
2418,myslet,27,22,5,2411,2257,5227
2419,nemely,27,18,9,2411,2788,2037
2420,spojeni,27,18,9,2411,2788,2037
2421,clenu,27,23,4,2411,2144,6257
2422,nemyslel,27,19,8,2411,2644,2605
2423,milose,27,20,7,2411,2502,3258
2424,bojove,27,16,11,2411,3148,1469
2425,realizace,27,19,8,2411,2644,2605
2426,noc,27,17,10,2411,2956,1723
2427,realizovat,27,25,2,2411,1927,10460
2428,silny,27,18,9,2411,2788,2037
2429,ksc,27,14,13,2411,3621,1135
2430,rozmistit,27,27,0,2411,1776,49909
2431,pratele,27,18,9,2411,2788,2037
2432,svazu,27,22,5,2411,2257,5227
2433,gru,27,20,7,2411,2502,3258
2434,zaver,27,23,4,2411,2144,6257
2435,efekt,27,22,5,2411,2257,5227
2436,uvadi,27,24,3,2411,2030,7621
2437,prestane,27,17,10,2411,2956,1723
2438,vseobecne,27,15,12,2411,3369,1282
2439,vypadalo,27,17,10,2411,2956,1723
2440,plneni,27,14,13,2411,3621,1135
2441,temto,27,20,7,2411,2502,3258
2442,stejna,27,26,1,2411,1846,20351
2443,tendru,27,24,3,2411,2030,7621
2444,drtiva,27,24,3,2411,2030,7621
2445,zavest,27,16,11,2411,3148,1469
2446,dopravy,27,15,12,2411,3369,1282
2447,noviny,27,15,12,2411,3369,1282
2448,houby,27,22,5,2411,2257,5227
2449,vetsiny,27,18,9,2411,2788,2037
2450,cinske,27,22,5,2411,2257,5227
2451,odstaveni,27,21,6,2411,2372,4187
2452,spoluprace,27,25,2,2411,1927,10460
2453,neprijatelne,27,16,11,2411,3148,1469
2454,opak,27,24,3,2411,2030,7621
2455,jistotu,27,23,4,2411,2144,6257
2456,trikrat,27,12,15,2411,4264,904
2457,hrozby,27,25,2,2411,1927,10460
2458,druhem,27,19,8,2411,2644,2605
2459,podobnych,27,21,6,2411,2372,4187
2460,rozhodnout,27,22,5,2411,2257,5227
2461,podani,27,19,8,2411,2644,2605
2462,kwh,27,27,0,2411,1776,49909
2463,jasna,27,20,7,2411,2502,3258
2464,vymenit,27,18,9,2411,2788,2037
2465,vyresi,27,27,0,2411,1776,49909
2466,zavedeni,27,14,13,2411,3621,1135
2467,dnu,27,23,4,2411,2144,6257
2468,mluvci,26,26,0,2522,1846,49909
2469,vyznamenani,26,24,2,2522,2030,10460
2470,rakete,26,19,7,2522,2644,3258
2471,vydrzi,26,20,6,2522,2502,4187
2472,svaz,26,19,7,2522,2644,3258
2473,svedci,26,22,4,2522,2257,6257
2474,mlady,26,14,12,2522,3621,1282
2475,zahranicnich,26,24,2,2522,2030,10460
2476,predsedy,26,16,10,2522,3148,1723
2477,resenim,26,24,2,2522,2030,10460
2478,demokraty,26,24,2,2522,2030,10460
2479,centru,26,22,4,2522,2257,6257
2480,tiskove,26,13,13,2522,3915,1135
2481,plynove,26,24,2,2522,2030,10460
2482,divit,26,18,8,2522,2788,2605
2483,dukaz,26,24,2,2522,2030,10460
2484,tydnech,26,26,0,2522,1846,49909
2485,seznamu,26,21,5,2522,2372,5227
2486,vedouci,26,19,7,2522,2644,3258
2487,slunecni,26,26,0,2522,1846,49909
2488,neexistuji,26,22,4,2522,2257,6257
2489,dusledky,26,23,3,2522,2144,7621
2490,hrube,26,12,14,2522,4264,1009
2491,jakekoli,26,23,3,2522,2144,7621
2492,radiace,26,24,2,2522,2030,10460
2493,slib,26,18,8,2522,2788,2605
2494,hubu,26,8,18,2522,6471,689
2495,priznat,26,24,2,2522,2030,10460
2496,studena,26,17,9,2522,2956,2037
2497,merkelova,26,22,4,2522,2257,6257
2498,velvyslanec,26,15,11,2522,3369,1469
2499,merkelove,26,22,4,2522,2257,6257
2500,vyhrozuji,26,22,4,2522,2257,6257
2501,tamni,26,21,5,2522,2372,5227
2502,mest,26,21,5,2522,2372,5227
2503,kapitalismus,26,20,6,2522,2502,4187
2504,shromazdeni,26,18,8,2522,2788,2605
2505,oborech,26,17,9,2522,2956,2037
2506,zaplatit,26,24,2,2522,2030,10460
2507,zpusobi,26,26,0,2522,1846,49909
2508,mnohokrat,26,13,13,2522,3915,1135
2509,delal,26,15,11,2522,3369,1469
2510,soudu,26,18,8,2522,2788,2605
2511,doprava,26,20,6,2522,2502,4187
2512,baterii,26,24,2,2522,2030,10460
2513,radek,26,24,2,2522,2030,10460
2514,dokumenty,26,13,13,2522,3915,1135
2515,arzenalu,26,24,2,2522,2030,10460
2516,nohavicovi,26,26,0,2522,1846,49909
2517,ctu,26,11,15,2522,4658,904
2518,obrovsky,26,22,4,2522,2257,6257
2519,kauza,26,23,3,2522,2144,7621
2520,point,26,25,1,2522,1927,20351
2521,paliv,26,26,0,2522,1846,49909
2522,tandem,26,25,1,2522,1927,20351
2523,uspech,26,12,14,2522,4264,1009
2524,kalousek,26,8,18,2522,6471,689
2525,dokonale,26,19,7,2522,2644,3258
2526,bakalovi,26,26,0,2522,1846,49909
2527,karel,26,17,9,2522,2956,2037
2528,nynejsi,26,21,5,2522,2372,5227
2529,znameni,26,12,14,2522,4264,1009
2530,logicke,26,24,2,2522,2030,10460
2531,cituji,26,22,4,2522,2257,6257
2532,statum,26,21,5,2522,2372,5227
2533,clovekem,26,15,11,2522,3369,1469
2534,sovetske,26,23,3,2522,2144,7621
2535,predvedl,26,15,11,2522,3369,1469
2536,dokazali,26,23,3,2522,2144,7621
2537,strategicke,26,26,0,2522,1846,49909
2538,zvysovat,26,20,6,2522,2502,4187
2539,nejprve,26,18,8,2522,2788,2605
2540,pripraven,26,16,10,2522,3148,1723
2541,kdepak,26,16,10,2522,3148,1723
2542,najevo,26,23,3,2522,2144,7621
2543,umet,26,18,8,2522,2788,2605
2544,hlavicemi,26,25,1,2522,1927,20351
2545,vasim,26,12,14,2522,4264,1009
2546,zustat,26,22,4,2522,2257,6257
2547,polovina,26,24,2,2522,2030,10460
2548,volba,26,14,12,2522,3621,1282
2549,znam,26,12,14,2522,4264,1009
2550,banky,26,19,7,2522,2644,3258
2551,necemu,26,13,13,2522,3915,1135
2552,byva,26,15,11,2522,3369,1469
2553,most,26,19,7,2522,2644,3258
2554,stanice,26,20,6,2522,2502,4187
2555,tezce,26,20,6,2522,2502,4187
2556,odveta,26,26,0,2522,1846,49909
2557,zdravotni,26,14,12,2522,3621,1282
2558,clenstvi,26,17,9,2522,2956,2037
2559,neplati,26,24,2,2522,2030,10460
2560,pripomenout,26,24,2,2522,2030,10460
2561,tajemstvi,26,16,10,2522,3148,1723
2562,kosmickeho,26,20,6,2522,2502,4187
2563,terorismu,26,16,10,2522,3148,1723
2564,informovali,26,15,11,2522,3369,1469
2565,rocni,26,21,5,2522,2372,5227
2566,svobody,26,17,9,2522,2956,2037
2567,chapete,26,22,4,2522,2257,6257
2568,mladsi,26,10,16,2522,5148,819
2569,tajnych,26,24,2,2522,2030,10460
2570,dnech,26,21,5,2522,2372,5227
2571,clintonovym,26,22,4,2522,2257,6257
2572,deseti,26,21,5,2522,2372,5227
2573,ohrozuje,26,22,4,2522,2257,6257
2574,hlavou,26,20,6,2522,2502,4187
2575,vetsinove,26,15,11,2522,3369,1469
2576,jinemu,25,23,2,2633,2144,10460
2577,nemuzes,25,16,9,2633,3148,2037
2578,donald,25,21,4,2633,2372,6257
2579,panelu,25,25,0,2633,1927,49909
2580,dovolim,25,15,10,2633,3369,1723
2581,letecke,25,21,4,2633,2372,6257
2582,kavicce,25,21,4,2633,2372,6257
2583,lete,25,17,8,2633,2956,2605
2584,predem,25,18,7,2633,2788,3258
2585,zalezitost,25,20,5,2633,2502,5227
2586,obcan,25,13,12,2633,3915,1282
2587,ustavy,25,15,10,2633,3369,1723
2588,ukrajinskeho,25,16,9,2633,3148,2037
2589,rostouci,25,23,2,2633,2144,10460
2590,ukrajinsti,25,15,10,2633,3369,1723
2591,potize,25,12,13,2633,4264,1135
2592,dob,25,19,6,2633,2644,4187
2593,donecke,25,10,15,2633,5148,904
2594,porosenko,25,16,9,2633,3148,2037
2595,prestaly,25,18,7,2633,2788,3258
2596,patnacti,25,14,11,2633,3621,1469
2597,vode,25,21,4,2633,2372,6257
2598,prislo,25,18,7,2633,2788,3258
2599,ukrajinskych,25,15,10,2633,3369,1723
2600,prosadit,25,23,2,2633,2144,10460
2601,zbavit,25,23,2,2633,2144,10460
2602,znici,25,24,1,2633,2030,20351
2603,vojak,25,18,7,2633,2788,3258
2604,zakladnu,25,21,4,2633,2372,6257
2605,novinari,25,16,9,2633,3148,2037
2606,predstavuje,25,20,5,2633,2502,5227
2607,povede,25,15,10,2633,3369,1723
2608,diskutovat,25,20,5,2633,2502,5227
2609,mpotweetuje,25,24,1,2633,2030,20351
2610,okundra,25,23,2,2633,2144,10460
2611,zmatek,25,17,8,2633,2956,2605
2612,krom,25,21,4,2633,2372,6257
2613,cekaji,25,19,6,2633,2644,4187
2614,bavit,25,23,2,2633,2144,10460
2615,start,25,25,0,2633,1927,49909
2616,civilni,25,21,4,2633,2372,6257
2617,vetrnych,25,24,1,2633,2030,20351
2618,ucinnost,25,23,2,2633,2144,10460
2619,michal,25,15,10,2633,3369,1723
2620,pokusu,25,24,1,2633,2030,20351
2621,dostalo,25,18,7,2633,2788,3258
2622,vyjde,25,24,1,2633,2030,20351
2623,zautocit,25,17,8,2633,2956,2605
2624,rozkaz,25,23,2,2633,2144,10460
2625,mrtvych,25,15,10,2633,3369,1723
2626,jinam,25,12,13,2633,4264,1135
2627,pisu,25,14,11,2633,3621,1469
2628,ukaze,25,20,5,2633,2502,5227
2629,pravidel,25,22,3,2633,2257,7621
2630,ss,25,20,5,2633,2502,5227
2631,poslanec,25,12,13,2633,4264,1135
2632,aj,25,19,6,2633,2644,4187
2633,severu,25,22,3,2633,2257,7621
2634,kratke,25,12,13,2633,4264,1135
2635,lidech,25,18,7,2633,2788,3258
2636,kyjeva,25,14,11,2633,3621,1469
2637,zpusoby,25,16,9,2633,3148,2037
2638,stesti,25,17,8,2633,2956,2605
2639,zduraznil,25,23,2,2633,2144,10460
2640,dokumentaci,25,25,0,2633,1927,49909
2641,platy,25,17,8,2633,2956,2605
2642,planuje,25,23,2,2633,2144,10460
2643,uran,25,20,5,2633,2502,5227
2644,minuleho,25,21,4,2633,2372,6257
2645,sovetskeho,25,22,3,2633,2257,7621
2646,tv,25,21,4,2633,2372,6257
2647,britska,25,21,4,2633,2372,6257
2648,zacinaji,25,17,8,2633,2956,2605
2649,jedinym,25,23,2,2633,2144,10460
2650,nerozumim,25,15,10,2633,3369,1723
2651,hre,25,22,3,2633,2257,7621
2652,laska,25,10,15,2633,5148,904
2653,napadnout,25,24,1,2633,2030,20351
2654,sportovni,25,22,3,2633,2257,7621
2655,rychleji,25,19,6,2633,2644,4187
2656,kim,25,25,0,2633,1927,49909
2657,napadlo,25,12,13,2633,4264,1135
2658,zadarmo,25,22,3,2633,2257,7621
2659,iskander,25,21,4,2633,2372,6257
2660,odpadem,25,25,0,2633,1927,49909
2661,vrazdy,25,17,8,2633,2956,2605
2662,david,25,14,11,2633,3621,1469
2663,statnich,25,23,2,2633,2144,10460
2664,bombardovani,25,22,3,2633,2257,7621
2665,sefa,25,12,13,2633,4264,1135
2666,postup,25,20,5,2633,2502,5227
2667,snizit,25,24,1,2633,2030,20351
2668,socialismu,25,17,8,2633,2956,2605
2669,times,25,18,7,2633,2788,3258
2670,stovek,25,23,2,2633,2144,10460
2671,dodavek,25,19,6,2633,2644,4187
2672,nemyslite,25,13,12,2633,3915,1282
2673,zaslouzi,25,23,2,2633,2144,10460
2674,neveri,25,21,4,2633,2372,6257
2675,agentury,25,24,1,2633,2030,20351
2676,hdp,25,20,5,2633,2502,5227
2677,korea,25,23,2,2633,2144,10460
2678,banka,25,14,11,2633,3621,1469
2679,zastupci,25,20,5,2633,2502,5227
2680,nevidim,25,18,7,2633,2788,3258
2681,nenavist,25,13,12,2633,3915,1282
2682,zemannejedly,25,25,0,2633,1927,49909
2683,samy,25,20,5,2633,2502,5227
2684,brno,25,21,4,2633,2372,6257
2685,dolet,25,25,0,2633,1927,49909
2686,pises,25,16,9,2633,3148,2037
2687,najde,25,20,5,2633,2502,5227
2688,pripadech,25,22,3,2633,2257,7621
2689,samotneho,24,21,3,2752,2372,7621
2690,schopnost,24,19,5,2752,2644,5227
2691,dojem,24,19,5,2752,2644,5227
2692,fakticky,24,21,3,2752,2372,7621
2693,uvedla,24,21,3,2752,2372,7621
2694,dna,24,21,3,2752,2372,7621
2695,samotne,24,23,1,2752,2144,20351
2696,prodej,24,22,2,2752,2257,10460
2697,schuzku,24,23,1,2752,2144,20351
2698,volbami,24,16,8,2752,3148,2605
2699,planovani,24,15,9,2752,3369,2037
2700,oznaceni,24,19,5,2752,2644,5227
2701,schvaleni,24,15,9,2752,3369,2037
2702,necem,24,19,5,2752,2644,5227
2703,rozpocet,24,24,0,2752,2030,49909
2704,tehdejsi,24,20,4,2752,2502,6257
2705,neznalost,24,14,10,2752,3621,1723
2706,metal,24,23,1,2752,2144,20351
2707,udelaji,24,19,5,2752,2644,5227
2708,lasky,24,16,8,2752,3148,2605
2709,pronesl,24,23,1,2752,2144,20351
2710,dostava,24,20,4,2752,2502,6257
2711,experiment,24,17,7,2752,2956,3258
2712,palube,24,17,7,2752,2956,3258
2713,aktivni,24,16,8,2752,3148,2605
2714,lobby,24,23,1,2752,2144,20351
2715,vety,24,13,11,2752,3915,1469
2716,nejvetsich,24,17,7,2752,2956,3258
2717,socialisticke,24,17,7,2752,2956,3258
2718,popisuje,24,23,1,2752,2144,20351
2719,koncem,24,20,4,2752,2502,6257
2720,tesne,24,20,4,2752,2502,6257
2721,panely,24,21,3,2752,2372,7621
2722,vlak,24,14,10,2752,3621,1723
2723,pocty,24,15,9,2752,3369,2037
2724,suroviny,24,24,0,2752,2030,49909
2725,nicim,24,15,9,2752,3369,2037
2726,podporuje,24,22,2,2752,2257,10460
2727,rec,24,12,12,2752,4264,1282
2728,preventivnim,24,18,6,2752,2788,4187
2729,reality,24,18,6,2752,2788,4187
2730,panu,24,16,8,2752,3148,2605
2731,propagandy,24,10,14,2752,5148,1009
2732,otazce,24,20,4,2752,2502,6257
2733,httpstwittercomokundrastatus,24,24,0,2752,2030,49909
2734,info,24,19,5,2752,2644,5227
2735,nepozve,24,24,0,2752,2030,49909
2736,nedoslo,24,22,2,2752,2257,10460
2737,zadal,24,16,8,2752,3148,2605
2738,smutnou,24,17,7,2752,2956,3258
2739,nejnovejsi,24,21,3,2752,2372,7621
2740,vlast,24,14,10,2752,3621,1723
2741,uprimne,24,13,11,2752,3915,1469
2742,leda,24,13,11,2752,3915,1469
2743,stanici,24,15,9,2752,3369,2037
2744,technologicky,24,23,1,2752,2144,20351
2745,energetickeho,24,23,1,2752,2144,20351
2746,predchozich,24,12,12,2752,4264,1282
2747,katastrofalni,24,23,1,2752,2144,20351
2748,odpovim,24,10,14,2752,5148,1009
2749,nizke,24,18,6,2752,2788,4187
2750,planeta,24,23,1,2752,2144,20351
2751,hra,24,19,5,2752,2644,5227
2752,blaboly,24,13,11,2752,3915,1469
2753,hnusne,24,24,0,2752,2030,49909
2754,cteni,24,21,3,2752,2372,7621
2755,vytvori,24,15,9,2752,3369,2037
2756,nazev,24,16,8,2752,3148,2605
2757,sehnat,24,15,9,2752,3369,2037
2758,nasa,24,22,2,2752,2257,10460
2759,vystavbou,24,15,9,2752,3369,2037
2760,prolomit,24,24,0,2752,2030,49909
2761,pral,24,8,16,2752,6471,819
2762,bavi,24,12,12,2752,4264,1282
2763,vzor,24,12,12,2752,4264,1282
2764,internet,24,17,7,2752,2956,3258
2765,zrusi,24,15,9,2752,3369,2037
2766,odpovida,24,22,2,2752,2257,10460
2767,spotrebu,24,19,5,2752,2644,5227
2768,rozhodla,24,18,6,2752,2788,4187
2769,zahynulo,24,18,6,2752,2788,4187
2770,hloupe,24,11,13,2752,4658,1135
2771,obrovska,24,22,2,2752,2257,10460
2772,padu,24,13,11,2752,3915,1469
2773,hradni,24,17,7,2752,2956,3258
2774,blizkem,24,12,12,2752,4264,1282
2775,volice,24,11,13,2752,4658,1135
2776,pravomoci,24,16,8,2752,3148,2605
2777,sleduji,24,20,4,2752,2502,6257
2778,tepla,24,16,8,2752,3148,2605
2779,trvale,24,21,3,2752,2372,7621
2780,fosilni,24,24,0,2752,2030,49909
2781,zen,24,19,5,2752,2644,5227
2782,nabizi,24,15,9,2752,3369,2037
2783,ctvrty,24,20,4,2752,2502,6257
2784,mise,24,17,7,2752,2956,3258
2785,hloupy,24,7,17,2752,7377,754
2786,ekonomickych,24,16,8,2752,3148,2605
2787,vysvetlil,24,17,7,2752,2956,3258
2788,konstrukce,24,24,0,2752,2030,49909
2789,soucasny,24,20,4,2752,2502,6257
2790,pochopil,24,17,7,2752,2956,3258
2791,trumpova,24,19,5,2752,2644,5227
2792,pobrezi,24,21,3,2752,2372,7621
2793,pripomenme,24,16,8,2752,3148,2605
2794,ach,24,15,9,2752,3369,2037
2795,tunelu,24,16,8,2752,3148,2605
2796,organy,24,12,12,2752,4264,1282
2797,nefunguje,24,13,11,2752,3915,1469
2798,jednalo,24,24,0,2752,2030,49909
2799,vysokeho,24,16,8,2752,3148,2605
2800,odpor,24,11,13,2752,4658,1135
2801,belorusko,24,17,7,2752,2956,3258
2802,napsano,24,14,10,2752,3621,1723
2803,httpswwwnovinkyczekonomikazemansporadcipodporilijadroiprolomenitezebnichlimituhtml,24,24,0,2752,2030,49909
2804,padem,24,21,3,2752,2372,7621
2805,videli,24,13,11,2752,3915,1469
2806,dokola,24,17,7,2752,2956,3258
2807,prazske,24,16,8,2752,3148,2605
2808,protiruske,24,15,9,2752,3369,2037
2809,skripal,24,19,5,2752,2644,5227
2810,kupovat,24,19,5,2752,2644,5227
2811,chodit,24,11,13,2752,4658,1135
2812,organizovat,24,24,0,2752,2030,49909
2813,ziskali,24,22,2,2752,2257,10460
2814,vysoko,24,15,9,2752,3369,2037
2815,vetrniky,23,19,4,2871,2644,6257
2816,nejdriv,23,16,7,2871,3148,3258
2817,kterej,23,17,6,2871,2956,4187
2818,kontrole,23,15,8,2871,3369,2605
2819,svetovy,23,22,1,2871,2257,20351
2820,klaus,23,12,11,2871,4264,1469
2821,kruhu,23,12,11,2871,4264,1469
2822,upravy,23,14,9,2871,3621,2037
2823,silenstvi,23,11,12,2871,4658,1282
2824,klesat,23,16,7,2871,3148,3258
2825,svetoveho,23,21,2,2871,2372,10460
2826,motory,23,22,1,2871,2257,20351
2827,uhlobarona,23,23,0,2871,2144,49909
2828,vyzkouset,23,14,9,2871,3621,2037
2829,httppictwittercompaszhfw,23,23,0,2871,2144,49909
2830,vesnice,23,12,11,2871,4264,1469
2831,tomas,23,21,2,2871,2372,10460
2832,stopy,23,16,7,2871,3148,3258
2833,jih,23,16,7,2871,3148,3258
2834,bolseviku,23,10,13,2871,5148,1135
2835,prav,23,17,6,2871,2956,4187
2836,dopravu,23,18,5,2871,2788,5227
2837,zavazali,23,22,1,2871,2257,20351
2838,filmu,23,21,2,2871,2372,10460
2839,omyl,23,17,6,2871,2956,4187
2840,vztah,23,18,5,2871,2788,5227
2841,vysetrovaci,23,16,7,2871,3148,3258
2842,bojovych,23,22,1,2871,2257,20351
2843,historicke,23,20,3,2871,2502,7621
2844,ziskal,23,21,2,2871,2372,10460
2845,fin,23,23,0,2871,2144,49909
2846,realitu,23,20,3,2871,2502,7621
2847,vlasti,23,18,5,2871,2788,5227
2848,ptam,23,9,14,2871,5739,1009
2849,uvazovat,23,21,2,2871,2372,10460
2850,euro,23,12,11,2871,4264,1469
2851,samo,23,9,14,2871,5739,1009
2852,lidu,23,13,10,2871,3915,1723
2853,zabyvat,23,19,4,2871,2644,6257
2854,zraneni,23,13,10,2871,3915,1723
2855,samotny,23,18,5,2871,2788,5227
2856,osoby,23,20,3,2871,2502,7621
2857,znate,23,12,11,2871,4264,1469
2858,kscm,23,13,10,2871,3915,1723
2859,vetsim,23,19,4,2871,2644,6257
2860,pokracovani,23,20,3,2871,2502,7621
2861,danrisingup,23,23,0,2871,2144,49909
2862,prumyslove,23,18,5,2871,2788,5227
2863,zmena,23,18,5,2871,2788,5227
2864,neovlivnicz,23,23,0,2871,2144,49909
2865,zdali,23,12,11,2871,4264,1469
2866,tykac,23,23,0,2871,2144,49909
2867,tykace,23,23,0,2871,2144,49909
2868,existovat,23,20,3,2871,2502,7621
2869,vizi,23,20,3,2871,2502,7621
2870,ivan,23,16,7,2871,3148,3258
2871,sance,23,17,6,2871,2956,4187
2872,varuje,23,13,10,2871,3915,1723
2873,ruky,23,17,6,2871,2956,4187
2874,videa,23,16,7,2871,3148,3258
2875,biologicke,23,20,3,2871,2502,7621
2876,kdokoliv,23,13,10,2871,3915,1723
2877,vznikla,23,17,6,2871,2956,4187
2878,kanalu,23,14,9,2871,3621,2037
2879,vyhral,23,15,8,2871,3369,2605
2880,hodnotit,23,11,12,2871,4658,1282
2881,udaje,23,18,5,2871,2788,5227
2882,spocivajici,23,22,1,2871,2257,20351
2883,trestni,23,11,12,2871,4658,1282
2884,striktne,23,22,1,2871,2257,20351
2885,rozumu,23,19,4,2871,2644,6257
2886,celych,23,10,13,2871,5148,1135
2887,prd,23,17,6,2871,2956,4187
2888,pravdou,23,12,11,2871,4264,1469
2889,trvaleho,23,23,0,2871,2144,49909
2890,organizaci,23,21,2,2871,2372,10460
2891,letectva,23,14,9,2871,3621,2037
2892,pate,23,9,14,2871,5739,1009
2893,nemohli,23,18,5,2871,2788,5227
2894,ekonomickeho,23,17,6,2871,2956,4187
2895,dokumentu,23,21,2,2871,2372,10460
2896,projev,23,17,6,2871,2956,4187
2897,ukolu,23,17,6,2871,2956,4187
2898,irak,23,21,2,2871,2372,10460
2899,celku,23,17,6,2871,2956,4187
2900,bezi,23,20,3,2871,2502,7621
2901,vyroky,23,16,7,2871,3148,3258
2902,davaji,23,16,7,2871,3148,3258
2903,energiewende,23,18,5,2871,2788,5227
2904,polovinu,23,21,2,2871,2372,10460
2905,oddeleni,23,23,0,2871,2144,49909
2906,faze,23,10,13,2871,5148,1135
2907,bydleni,23,13,10,2871,3915,1723
2908,nechceme,23,19,4,2871,2644,6257
2909,predstavu,23,22,1,2871,2257,20351
2910,materialy,23,22,1,2871,2257,20351
2911,nepujde,23,14,9,2871,3621,2037
2912,unii,23,15,8,2871,3369,2605
2913,vhodne,23,21,2,2871,2372,10460
2914,dil,23,16,7,2871,3148,3258
2915,alexandr,23,15,8,2871,3369,2605
2916,svetovych,23,18,5,2871,2788,5227
2917,nechali,23,12,11,2871,4264,1469
2918,komunisty,23,10,13,2871,5148,1135
2919,generaci,23,19,4,2871,2644,6257
2920,cloveku,23,13,10,2871,3915,1723
2921,verejnosti,23,19,4,2871,2644,6257
2922,vznik,23,17,6,2871,2956,4187
2923,vybudovat,23,21,2,2871,2372,10460
2924,ropa,23,19,4,2871,2644,6257
2925,dlouha,23,19,4,2871,2644,6257
2926,zanedbatelne,23,10,13,2871,5148,1135
2927,jezdi,22,20,2,3008,2502,10460
2928,vyroku,22,16,6,3008,3148,4187
2929,pripojeni,22,19,3,3008,2644,7621
2930,zasadne,22,14,8,3008,3621,2605
2931,televize,22,15,7,3008,3369,3258
2932,nemocnice,22,22,0,3008,2257,49909
2933,vzdalenost,22,19,3,3008,2644,7621
2934,vcas,22,14,8,3008,3621,2605
2935,svycarsko,22,20,2,3008,2502,10460
2936,blabol,22,20,2,3008,2502,10460
2937,jj,22,8,14,3008,6471,1009
2938,vedena,22,21,1,3008,2372,20351
2939,elektronicke,22,22,0,3008,2257,49909
2940,podzim,22,12,10,3008,4264,1723
2941,doruci,22,22,0,3008,2257,49909
2942,samozrejmost,22,21,1,3008,2372,20351
2943,hromadneho,22,20,2,3008,2502,10460
2944,potrebne,22,20,2,3008,2502,10460
2945,rozumej,22,9,13,3008,5739,1135
2946,bestovi,22,22,0,3008,2257,49909
2947,opakuji,22,21,1,3008,2372,20351
2948,celym,22,18,4,3008,2788,6257
2949,pokryt,22,14,8,3008,3621,2605
2950,pohode,22,16,6,3008,3148,4187
2951,podpory,22,20,2,3008,2502,10460
2952,sefka,22,19,3,3008,2644,7621
2953,lekari,22,16,6,3008,3148,4187
2954,draha,22,19,3,3008,2644,7621
2955,uzivatele,22,15,7,3008,3369,3258
2956,africe,22,22,0,3008,2257,49909
2957,nepodari,22,20,2,3008,2502,10460
2958,chyby,22,14,8,3008,3621,2605
2959,spociva,22,10,12,3008,5148,1282
2960,stastny,22,7,15,3008,7377,904
2961,ses,22,13,9,3008,3915,2037
2962,mile,22,11,11,3008,4658,1469
2963,zminil,22,18,4,3008,2788,6257
2964,chaos,22,12,10,3008,4264,1723
2965,oponovat,22,14,8,3008,3621,2605
2966,chapat,22,13,9,3008,3915,2037
2967,diesely,22,22,0,3008,2257,49909
2968,nemyslim,22,15,7,3008,3369,3258
2969,techniku,22,20,2,3008,2502,10460
2970,wagner,22,19,3,3008,2644,7621
2971,mozek,22,16,6,3008,3148,4187
2972,nese,22,12,10,3008,4264,1723
2973,volit,22,5,17,3008,10298,754
2974,jezdit,22,17,5,3008,2956,5227
2975,provedeni,22,19,3,3008,2644,7621
2976,sedi,22,12,10,3008,4264,1723
2977,nemeckeho,22,20,2,3008,2502,10460
2978,nejvetsim,22,20,2,3008,2502,10460
2979,prvne,22,11,11,3008,4658,1469
2980,neresi,22,18,4,3008,2788,6257
2981,zasahu,22,18,4,3008,2788,6257
2982,nasla,22,21,1,3008,2372,20351
2983,nuceni,22,13,9,3008,3915,2037
2984,nazvu,22,11,11,3008,4658,1469
2985,bozi,22,14,8,3008,3621,2605
2986,stranky,22,14,8,3008,3621,2605
2987,nebezpecna,22,12,10,3008,4264,1723
2988,odejit,22,17,5,3008,2956,5227
2989,produktu,22,15,7,3008,3369,3258
2990,ucili,22,12,10,3008,4264,1723
2991,zememi,22,12,10,3008,4264,1723
2992,tezkou,22,18,4,3008,2788,6257
2993,precetl,22,10,12,3008,5148,1282
2994,vodik,22,20,2,3008,2502,10460
2995,nasilim,22,8,14,3008,6471,1009
2996,duchovni,22,18,4,3008,2788,6257
2997,hodnoceni,22,8,14,3008,6471,1009
2998,univerzity,22,19,3,3008,2644,7621
2999,premiera,22,15,7,3008,3369,3258
3000,kapsy,22,13,9,3008,3915,2037
3001,necha,22,19,3,3008,2644,7621
3002,krev,22,18,4,3008,2788,6257
3003,jakoukoliv,22,22,0,3008,2257,49909
3004,ministerstvu,22,12,10,3008,4264,1723
3005,odmita,22,21,1,3008,2372,20351
3006,jini,22,15,7,3008,3369,3258
3007,minulym,22,14,8,3008,3621,2605
3008,blbe,22,15,7,3008,3369,3258
3009,vstoupil,22,21,1,3008,2372,20351
3010,jakykoliv,22,16,6,3008,3148,4187
3011,dubcek,22,13,9,3008,3915,2037
3012,nedava,22,17,5,3008,2956,5227
3013,ekologicky,22,22,0,3008,2257,49909
3014,davidhavlik,22,22,0,3008,2257,49909
3015,bodu,22,15,7,3008,3369,3258
3016,prohlasila,22,15,7,3008,3369,3258
3017,ukoly,22,15,7,3008,3369,3258
3018,nasli,22,16,6,3008,3148,4187
3019,trech,22,12,10,3008,4264,1723
3020,mapy,22,22,0,3008,2257,49909
3021,ucitel,22,8,14,3008,6471,1009
3022,projevu,22,19,3,3008,2644,7621
3023,rezident,22,22,0,3008,2257,49909
3024,podivej,22,21,1,3008,2372,20351
3025,dulezitou,22,21,1,3008,2372,20351
3026,sluzebni,22,14,8,3008,3621,2605
3027,extremne,22,21,1,3008,2372,20351
3028,mirove,22,18,4,3008,2788,6257
3029,udalost,22,12,10,3008,4264,1723
3030,navrat,22,14,8,3008,3621,2605
3031,odborniku,22,15,7,3008,3369,3258
3032,duleziteho,22,22,0,3008,2257,49909
3033,vyhrat,22,20,2,3008,2502,10460
3034,ctyr,22,17,5,3008,2956,5227
3035,tresni,22,14,8,3008,3621,2605
3036,plutonia,22,22,0,3008,2257,49909
3037,masa,22,10,12,3008,5148,1282
3038,deni,22,19,3,3008,2644,7621
3039,navstevy,22,20,2,3008,2502,10460
3040,rikate,22,21,1,3008,2372,20351
3041,vietnamu,22,14,8,3008,3621,2605
3042,ukazal,22,20,2,3008,2502,10460
3043,zdejsi,22,15,7,3008,3369,3258
3044,zemetreseni,22,21,1,3008,2372,20351
3045,zalezelo,22,8,14,3008,6471,1009
3046,vstup,22,12,10,3008,4264,1723
3047,obsahuje,22,18,4,3008,2788,6257
3048,autora,22,17,5,3008,2956,5227
3049,nedokaze,22,13,9,3008,3915,2037
3050,bolton,22,21,1,3008,2372,20351
3051,sireni,22,19,3,3008,2644,7621
3052,nejakej,22,15,7,3008,3369,3258
3053,gratuluju,22,22,0,3008,2257,49909
3054,pokusy,22,14,8,3008,3621,2605
3055,jana,22,16,6,3008,3148,4187
3056,nedovoli,22,20,2,3008,2502,10460
3057,novakove,22,22,0,3008,2257,49909
3058,raketa,22,21,1,3008,2372,20351
3059,nabidka,22,20,2,3008,2502,10460
3060,pozemni,22,19,3,3008,2644,7621
3061,solarnich,22,21,1,3008,2372,20351
3062,pracovniku,22,14,8,3008,3621,2605
3063,zaveru,22,20,2,3008,2502,10460
3064,moznych,22,21,1,3008,2372,20351
3065,civilniho,22,22,0,3008,2257,49909
3066,prijatelnou,22,22,0,3008,2257,49909
3067,zed,22,20,2,3008,2502,10460
3068,raketovych,22,20,2,3008,2502,10460
3069,negativni,22,17,5,3008,2956,5227
3070,rakouska,22,21,1,3008,2372,20351
3071,cista,22,21,1,3008,2372,20351
3072,nedojde,22,19,3,3008,2644,7621
3073,umyslne,22,18,4,3008,2788,6257
3074,koncepce,22,20,2,3008,2502,10460
3075,vlasy,22,8,14,3008,6471,1009
3076,koncepci,22,20,2,3008,2502,10460
3077,podobneho,22,18,4,3008,2788,6257
3078,faktu,22,16,6,3008,3148,4187
3079,eur,22,20,2,3008,2502,10460
3080,mesicich,22,19,3,3008,2644,7621
3081,novymi,22,14,8,3008,3621,2605
3082,bere,22,12,10,3008,4264,1723
3083,nedeje,22,8,14,3008,6471,1009
3084,zalobce,22,22,0,3008,2257,49909
3085,byznys,22,22,0,3008,2257,49909
3086,omluva,22,8,14,3008,6471,1009
3087,desitkach,22,12,10,3008,4264,1723
3088,naprosty,21,17,4,3175,2956,6257
3089,prirozene,21,17,4,3175,2956,6257
3090,populace,21,15,6,3175,3369,4187
3091,rumunsku,21,18,3,3175,2788,7621
3092,soucasnych,21,20,1,3175,2502,20351
3093,vedl,21,15,6,3175,3369,4187
3094,tragedie,21,9,12,3175,5739,1282
3095,zvitezil,21,8,13,3175,6471,1135
3096,respektive,21,17,4,3175,2956,6257
3097,vedcu,21,18,3,3175,2788,7621
3098,zady,21,11,10,3175,4658,1723
3099,penezi,21,13,8,3175,3915,2605
3100,jednal,21,20,1,3175,2502,20351
3101,zasedani,21,15,6,3175,3369,4187
3102,dusi,21,11,10,3175,4658,1723
3103,poznamenal,21,15,6,3175,3369,4187
3104,zmenil,21,12,9,3175,4264,2037
3105,kandidovat,21,15,6,3175,3369,4187
3106,ostrova,21,17,4,3175,2956,6257
3107,kousek,21,15,6,3175,3369,4187
3108,varianta,21,18,3,3175,2788,7621
3109,vittto,21,13,8,3175,3915,2605
3110,vyber,21,19,2,3175,2644,10460
3111,bloomberg,21,17,4,3175,2956,6257
3112,drahy,21,16,5,3175,3148,5227
3113,pekny,21,12,9,3175,4264,2037
3114,sousedy,21,11,10,3175,4658,1723
3115,marta,21,20,1,3175,2502,20351
3116,martinczveu,21,21,0,3175,2372,49909
3117,preji,21,14,7,3175,3621,3258
3118,nevidi,21,11,10,3175,4658,1723
3119,povrch,21,17,4,3175,2956,6257
3120,sedmi,21,15,6,3175,3369,4187
3121,ostatnim,21,19,2,3175,2644,10460
3122,dostavet,21,20,1,3175,2502,20351
3123,dostavi,21,21,0,3175,2372,49909
3124,vychodu,21,19,2,3175,2644,10460
3125,prezidentovi,21,12,9,3175,4264,2037
3126,spravnym,21,15,6,3175,3369,4187
3127,realizovatelnosti,21,21,0,3175,2372,49909
3128,vydat,21,11,10,3175,4658,1723
3129,postavil,21,18,3,3175,2788,7621
3130,veleni,21,19,2,3175,2644,10460
3131,zrcadlove,21,12,9,3175,4264,2037
3132,rusvesnasu,21,8,13,3175,6471,1135
3133,reditele,21,9,12,3175,5739,1282
3134,hrozne,21,16,5,3175,3148,5227
3135,americanu,21,20,1,3175,2502,20351
3136,plynovych,21,21,0,3175,2372,49909
3137,debil,21,14,7,3175,3621,3258
3138,korejci,21,20,1,3175,2502,20351
3139,prinasi,21,17,4,3175,2956,6257
3140,pohrozilo,21,20,1,3175,2502,20351
3141,osud,21,8,13,3175,6471,1135
3142,sorry,21,12,9,3175,4264,2037
3143,bohate,21,16,5,3175,3148,5227
3144,plat,21,12,9,3175,4264,2037
3145,taktez,21,20,1,3175,2502,20351
3146,osobnosti,21,13,8,3175,3915,2605
3147,potraviny,21,18,3,3175,2788,7621
3148,tomahawk,21,15,6,3175,3369,4187
3149,latek,21,16,5,3175,3148,5227
3150,zvysuje,21,20,1,3175,2502,20351
3151,najdete,21,17,4,3175,2956,6257
3152,pozic,21,11,10,3175,4658,1723
3153,pochybuji,21,13,8,3175,3915,2605
3154,zdravotnictvi,21,12,9,3175,4264,2037
3155,snazit,21,10,11,3175,5148,1469
3156,energetickych,21,16,5,3175,3148,5227
3157,odtud,21,9,12,3175,5739,1282
3158,jejiz,21,16,5,3175,3148,5227
3159,privedeneho,21,21,0,3175,2372,49909
3160,znamenat,21,18,3,3175,2788,7621
3161,prineslo,21,15,6,3175,3369,4187
3162,udelaly,21,14,7,3175,3621,3258
3163,upekli,21,7,14,3175,7377,1009
3164,reky,21,15,6,3175,3369,4187
3165,odborne,21,20,1,3175,2502,20351
3166,mire,21,17,4,3175,2956,6257
3167,jmenuje,21,16,5,3175,3148,5227
3168,bral,21,11,10,3175,4658,1723
3169,dobrou,21,10,11,3175,5148,1469
3170,minulost,21,8,13,3175,6471,1135
3171,nestane,21,17,4,3175,2956,6257
3172,ukonceni,21,19,2,3175,2644,10460
3173,modulu,21,12,9,3175,4264,2037
3174,matka,21,13,8,3175,3915,2605
3175,zverejneny,21,13,8,3175,3915,2605
3176,barak,21,11,10,3175,4658,1723
3177,jedini,21,19,2,3175,2644,10460
3178,vracet,21,7,14,3175,7377,1009
3179,jakesi,21,12,9,3175,4264,2037
3180,jakkoliv,21,12,9,3175,4264,2037
3181,vasem,21,8,13,3175,6471,1135
3182,opakovat,21,18,3,3175,2788,7621
3183,vztazich,21,13,8,3175,3915,2605
3184,rocniku,21,11,10,3175,4658,1723
3185,obavam,21,19,2,3175,2644,10460
3186,francouzi,21,20,1,3175,2502,20351
3187,nechame,21,15,6,3175,3369,4187
3188,logiky,21,16,5,3175,3148,5227
3189,dlouholeta,21,21,0,3175,2372,49909
3190,roman,21,16,5,3175,3148,5227
3191,necetl,21,10,11,3175,5148,1469
3192,obchod,21,17,4,3175,2956,6257
3193,nebyt,21,16,5,3175,3148,5227
3194,tezka,21,19,2,3175,2644,10460
3195,svobodni,21,10,11,3175,5148,1469
3196,probihaji,21,14,7,3175,3621,3258
3197,parku,21,19,2,3175,2644,10460
3198,panem,21,18,3,3175,2788,7621
3199,obhajuje,21,11,10,3175,4658,1723
3200,vyrobene,21,18,3,3175,2788,7621
3201,fotovoltaiky,21,17,4,3175,2956,6257
3202,chvile,21,13,8,3175,3915,2605
3203,fotovoltaika,21,17,4,3175,2956,6257
3204,umozni,21,18,3,3175,2788,7621
3205,nazvem,21,16,5,3175,3148,5227
3206,nazvat,21,7,14,3175,7377,1009
3207,trumpovi,21,17,4,3175,2956,6257
3208,spatna,21,14,7,3175,3621,3258
3209,mnohdy,21,16,5,3175,3148,5227
3210,dukazem,21,13,8,3175,3915,2605
3211,vyzval,21,11,10,3175,4658,1723
3212,blb,21,17,4,3175,2956,6257
3213,studium,21,11,10,3175,4658,1723
3214,drzel,21,9,12,3175,5739,1282
3215,pakistan,21,20,1,3175,2502,20351
3216,pakistanu,21,17,4,3175,2956,6257
3217,teplo,21,13,8,3175,3915,2605
3218,nordstreamem,21,21,0,3175,2372,49909
3219,sile,21,14,7,3175,3621,3258
3220,predstavy,21,9,12,3175,5739,1282
3221,autobusem,21,11,10,3175,4658,1723
3222,norsku,21,16,5,3175,3148,5227
3223,vyjimky,21,9,12,3175,5739,1282
3224,tereza,21,17,4,3175,2956,6257
3225,horke,21,11,10,3175,4658,1723
3226,ameriku,21,17,4,3175,2956,6257
3227,pada,21,12,9,3175,4264,2037
3228,typy,21,18,3,3175,2788,7621
3229,nejlevnejsi,21,16,5,3175,3148,5227
3230,srdci,21,13,8,3175,3915,2605
3231,indii,21,20,1,3175,2502,20351
3232,vyresit,21,18,3,3175,2788,7621
3233,rozdeleni,21,20,1,3175,2502,20351
3234,novinar,21,13,8,3175,3915,2605
3235,nicit,21,20,1,3175,2502,20351
3236,pamet,21,11,10,3175,4658,1723
3237,pac,21,13,8,3175,3915,2605
3238,dopadlo,21,13,8,3175,3915,2605
3239,podporuji,21,19,2,3175,2644,10460
3240,plnou,21,15,6,3175,3369,4187
3241,letiste,21,21,0,3175,2372,49909
3242,vyhodne,21,16,5,3175,3148,5227
3243,nastoleni,21,21,0,3175,2372,49909
3244,zkusenost,21,20,1,3175,2502,20351
3245,viru,21,14,7,3175,3621,3258
3246,problemem,21,19,2,3175,2644,10460
3247,ustavni,21,4,17,3175,12632,754
3248,vysokou,21,16,5,3175,3148,5227
3249,prokazuje,21,21,0,3175,2372,49909
3250,twh,21,20,1,3175,2502,20351
3251,hradu,21,11,10,3175,4658,1723
3252,blizkosti,21,18,3,3175,2788,7621
3253,detstvi,21,11,10,3175,4658,1723
3254,spojencu,21,21,0,3175,2372,49909
3255,kralovstvi,21,10,11,3175,5148,1469
3256,brusel,21,20,1,3175,2502,20351
3257,mezinarodnim,21,12,9,3175,4264,2037
3258,obrana,21,17,4,3175,2956,6257
3259,nemoc,21,16,5,3175,3148,5227
3260,otec,21,12,9,3175,4264,2037
3261,vyznamnou,21,16,5,3175,3148,5227
3262,mosty,20,12,8,3358,4264,2605
3263,vysokych,20,11,9,3358,4658,2037
3264,uprchliku,20,18,2,3358,2788,10460
3265,slusne,20,4,16,3358,12632,819
3266,usili,20,19,1,3358,2644,20351
3267,prodavat,20,17,3,3358,2956,7621
3268,stroju,20,17,3,3358,2956,7621
3269,pravni,20,12,8,3358,4264,2605
3270,predstava,20,13,7,3358,3915,3258
3271,samostatne,20,13,7,3358,3915,3258
3272,postavena,20,12,8,3358,4264,2605
3273,vrazdeni,20,19,1,3358,2644,20351
3274,mrtve,20,13,7,3358,3915,3258
3275,amater,20,19,1,3358,2644,20351
3276,sluzba,20,9,11,3358,5739,1469
3277,chape,20,17,3,3358,2956,7621
3278,prince,20,12,8,3358,4264,2605
3279,nahoru,20,11,9,3358,4658,2037
3280,jdu,20,7,13,3358,7377,1135
3281,schvalne,20,12,8,3358,4264,2605
3282,bacha,20,7,13,3358,7377,1135
3283,mediich,20,13,7,3358,3915,3258
3284,fungujici,20,20,0,3358,2502,49909
3285,zahynul,20,16,4,3358,3148,6257
3286,podobny,20,11,9,3358,4658,2037
3287,mesici,20,18,2,3358,2788,10460
3288,vysilani,20,17,3,3358,2956,7621
3289,zabit,20,14,6,3358,3621,4187
3290,zasah,20,17,3,3358,2956,7621
3291,dele,20,13,7,3358,3915,3258
3292,nasledovat,20,19,1,3358,2644,20351
3293,aha,20,12,8,3358,4264,2605
3294,prosince,20,18,2,3358,2788,10460
3295,uvidi,20,18,2,3358,2788,10460
3296,soudruhu,20,9,11,3358,5739,1469
3297,cinska,20,20,0,3358,2502,49909
3298,vyhodu,20,17,3,3358,2956,7621
3299,poslanecke,20,16,4,3358,3148,6257
3300,soucasneho,20,17,3,3358,2956,7621
3301,sou,20,14,6,3358,3621,4187
3302,slozite,20,18,2,3358,2788,10460
3303,palivem,20,20,0,3358,2502,49909
3304,vyuziva,20,17,3,3358,2956,7621
3305,poslou,20,15,5,3358,3369,5227
3306,manipulace,20,19,1,3358,2644,20351
3307,pochazi,20,18,2,3358,2788,10460
3308,chodniky,20,8,12,3358,6471,1282
3309,katastrofe,20,17,3,3358,2956,7621
3310,prodat,20,19,1,3358,2644,20351
3311,dodavatele,20,17,3,3358,2956,7621
3312,zahrade,20,13,7,3358,3915,3258
3313,fascinujici,20,17,3,3358,2956,7621
3314,spencerova,20,15,5,3358,3369,5227
3315,prezidentu,20,20,0,3358,2502,49909
3316,cizinci,20,10,10,3358,5148,1723
3317,vybrali,20,11,9,3358,4658,2037
3318,investovat,20,15,5,3358,3369,5227
3319,protiraketovy,20,17,3,3358,2956,7621
3320,evropska,20,16,4,3358,3148,6257
3321,inteligence,20,16,4,3358,3148,6257
3322,skoncilo,20,12,8,3358,4264,2605
3323,namisto,20,11,9,3358,4658,2037
3324,jeli,20,9,11,3358,5739,1469
3325,vyvolat,20,19,1,3358,2644,20351
3326,dostanu,20,10,10,3358,5148,1723
3327,znel,20,17,3,3358,2956,7621
3328,zustalo,20,15,5,3358,3369,5227
3329,pravem,20,14,6,3358,3621,4187
3330,navrhuje,20,14,6,3358,3621,4187
3331,ovar,20,11,9,3358,4658,2037
3332,zisky,20,14,6,3358,3621,4187
3333,akcionaru,20,17,3,3358,2956,7621
3334,dobreho,20,15,5,3358,3369,5227
3335,tydne,20,14,6,3358,3621,4187
3336,varoval,20,13,7,3358,3915,3258
3337,evropskou,20,18,2,3358,2788,10460
3338,stupen,20,20,0,3358,2502,49909
3339,nepostavi,20,19,1,3358,2644,20351
3340,vytvorenych,20,20,0,3358,2502,49909
3341,prijmout,20,11,9,3358,4658,2037
3342,mysleno,20,11,9,3358,4658,2037
3343,hun,20,20,0,3358,2502,49909
3344,jadernemu,20,19,1,3358,2644,20351
3345,masove,20,13,7,3358,3915,3258
3346,zakladna,20,16,4,3358,3148,6257
3347,snahy,20,19,1,3358,2644,20351
3348,detem,20,12,8,3358,4264,2605
3349,struktury,20,19,1,3358,2644,20351
3350,nemysli,20,16,4,3358,3148,6257
3351,francouzske,20,17,3,3358,2956,7621
3352,clancich,20,11,9,3358,4658,2037
3353,naznacuje,20,18,2,3358,2788,10460
3354,finsky,20,20,0,3358,2502,49909
3355,aktiviste,20,17,3,3358,2956,7621
3356,nechape,20,17,3,3358,2956,7621
3357,vyzyva,20,11,9,3358,4658,2037
3358,maximalni,20,17,3,3358,2956,7621
3359,svine,20,9,11,3358,5739,1469
3360,latka,20,13,7,3358,3915,3258
3361,idealni,20,15,5,3358,3369,5227
3362,zverejnil,20,10,10,3358,5148,1723
3363,vystoupil,20,4,16,3358,12632,819
3364,nemuzete,20,10,10,3358,5148,1723
3365,takoveto,20,18,2,3358,2788,10460
3366,prima,20,17,3,3358,2956,7621
3367,dokazi,20,19,1,3358,2644,20351
3368,vudce,20,13,7,3358,3915,3258
3369,spalovani,20,18,2,3358,2788,10460
3370,cosi,20,16,4,3358,3148,6257
3371,firmu,20,16,4,3358,3148,6257
3372,jakoby,20,11,9,3358,4658,2037
3373,zakladnich,20,11,9,3358,4658,2037
3374,dobou,20,14,6,3358,3621,4187
3375,dohode,20,19,1,3358,2644,20351
3376,uk,20,17,3,3358,2956,7621
3377,skolach,20,13,7,3358,3915,3258
3378,dostupne,20,12,8,3358,4264,2605
3379,cechy,20,17,3,3358,2956,7621
3380,veskerou,20,13,7,3358,3915,3258
3381,veskera,20,18,2,3358,2788,10460
3382,vojska,20,16,4,3358,3148,6257
3383,trend,20,12,8,3358,4264,2605
3384,miry,20,19,1,3358,2644,20351
3385,rusi,20,12,8,3358,4264,2605
3386,vesele,20,17,3,3358,2956,7621
3387,pouzili,20,12,8,3358,4264,2605
3388,stabu,20,9,11,3358,5739,1469
3389,vysec,20,20,0,3358,2502,49909
3390,pouzil,20,16,4,3358,3148,6257
3391,dluhy,20,10,10,3358,5148,1723
3392,zazemi,20,11,9,3358,4658,2037
3393,politikum,20,12,8,3358,4264,2605
3394,poslal,20,16,4,3358,3148,6257
3395,titulek,20,15,5,3358,3369,5227
3396,nestoji,20,18,2,3358,2788,10460
3397,ulici,20,10,10,3358,5148,1723
3398,vyrobce,20,19,1,3358,2644,20351
3399,ocekavat,20,19,1,3358,2644,20351
3400,zemim,20,17,3,3358,2956,7621
3401,stara,20,11,9,3358,4658,2037
3402,vnitrni,20,18,2,3358,2788,10460
3403,komplex,20,17,3,3358,2956,7621
3404,vznika,20,18,2,3358,2788,10460
3405,pudy,20,17,3,3358,2956,7621
3406,autokefalii,20,10,10,3358,5148,1723
3407,vzpominam,20,12,8,3358,4264,2605
3408,olej,20,19,1,3358,2644,20351
3409,obchodni,20,17,3,3358,2956,7621
3410,autokefalie,20,12,8,3358,4264,2605
3411,zavrit,20,19,1,3358,2644,20351
3412,jizda,20,9,11,3358,5739,1469
3413,mlade,20,13,7,3358,3915,3258
3414,vetu,20,10,10,3358,5148,1723
3415,starosti,20,12,8,3358,4264,2605
3416,hodil,20,13,7,3358,3915,3258
3417,elity,20,16,4,3358,3148,6257
3418,komise,20,14,6,3358,3621,4187
3419,objevily,20,15,5,3358,3369,5227
3420,honzapalicka,20,20,0,3358,2502,49909
3421,rikali,20,9,11,3358,5739,1469
3422,povinnosti,20,11,9,3358,4658,2037
3423,norska,20,16,4,3358,3148,6257
3424,mist,20,18,2,3358,2788,10460
3425,okamzik,20,10,10,3358,5148,1723
3426,mimoradne,20,15,5,3358,3369,5227
3427,komunisticke,20,16,4,3358,3148,6257
3428,prevazne,20,18,2,3358,2788,10460
3429,prirodnich,20,19,1,3358,2644,20351
3430,odhad,20,15,5,3358,3369,5227
3431,beztak,20,19,1,3358,2644,20351
3432,raketu,20,17,3,3358,2956,7621
3433,trumpuv,20,15,5,3358,3369,5227
3434,tele,20,19,1,3358,2644,20351
3435,nevis,20,10,10,3358,5148,1723
3436,tohohle,20,10,10,3358,5148,1723
3437,volne,20,18,2,3358,2788,10460
3438,nevime,20,12,8,3358,4264,2605
3439,vymyslet,20,14,6,3358,3621,4187
3440,ven,20,16,4,3358,3148,6257
3441,celosvetove,20,11,9,3358,4658,2037
3442,google,20,17,3,3358,2956,7621
3443,afghanistan,20,11,9,3358,4658,2037
3444,pobytu,20,14,6,3358,3621,4187
3445,prvku,20,17,3,3358,2956,7621
3446,kontroly,20,18,2,3358,2788,10460
3447,nezbytne,20,19,1,3358,2644,20351
3448,hlas,20,6,14,3358,8574,1009
3449,rana,20,18,2,3358,2788,10460
3450,rukama,20,13,7,3358,3915,3258
3451,jezdil,20,8,12,3358,6471,1282
3452,jistotou,20,13,7,3358,3915,3258
3453,likvidovat,19,15,4,3554,3369,6257
3454,zone,19,13,6,3554,3915,4187
3455,horni,19,15,4,3554,3369,6257
3456,pracovnik,19,16,3,3554,3148,7621
3457,jindy,19,12,7,3554,4264,3258
3458,elektrickeho,19,14,5,3554,3621,5227
3459,kroku,19,10,9,3554,5148,2037
3460,novinach,19,13,6,3554,3915,4187
3461,nosicu,19,18,1,3554,2788,20351
3462,kuby,19,19,0,3554,2644,49909
3463,linii,19,11,8,3554,4658,2605
3464,infrastruktura,19,19,0,3554,2644,49909
3465,bydlet,19,10,9,3554,5148,2037
3466,chova,19,11,8,3554,4658,2605
3467,vykonnost,19,13,6,3554,3915,4187
3468,bezna,19,18,1,3554,2788,20351
3469,nutnosti,19,19,0,3554,2644,49909
3470,populaci,19,9,10,3554,5739,1723
3471,nechteli,19,8,11,3554,6471,1469
3472,panove,19,15,4,3554,3369,6257
3473,vanecku,19,18,1,3554,2788,20351
3474,pripojit,19,18,1,3554,2788,20351
3475,nenapadne,19,9,10,3554,5739,1723
3476,bytu,19,17,2,3554,2956,10460
3477,pracne,19,19,0,3554,2644,49909
3478,sel,19,15,4,3554,3369,6257
3479,rozumni,19,19,0,3554,2644,49909
3480,silene,19,18,1,3554,2788,20351
3481,nedeli,19,16,3,3554,3148,7621
3482,omezit,19,13,6,3554,3915,4187
3483,lidskeho,19,19,0,3554,2644,49909
3484,voli,19,8,11,3554,6471,1469
3485,nikam,19,14,5,3554,3621,5227
3486,fungovalo,19,13,6,3554,3915,4187
3487,kdybychom,19,14,5,3554,3621,5227
3488,vydiranim,19,13,6,3554,3915,4187
3489,nemeckou,19,12,7,3554,4264,3258
3490,vaclavmoravec,19,19,0,3554,2644,49909
3491,nejvyhodnejsi,19,17,2,3554,2956,10460
3492,pricinou,19,11,8,3554,4658,2605
3493,nejvyssiho,19,11,8,3554,4658,2605
3494,nezna,19,11,8,3554,4658,2605
3495,idealne,19,17,2,3554,2956,10460
3496,fyzicky,19,11,8,3554,4658,2605
3497,vystoupeni,19,17,2,3554,2956,10460
3498,sviti,19,12,7,3554,4264,3258
3499,nezmeni,19,18,1,3554,2788,20351
3500,jmena,19,11,8,3554,4658,2605
3501,opozice,19,10,9,3554,5148,2037
3502,drogy,19,8,11,3554,6471,1469
3503,bezmezne,19,9,10,3554,5739,1723
3504,beru,19,15,4,3554,3369,6257
3505,casopis,19,8,11,3554,6471,1469
3506,prvky,19,17,2,3554,2956,10460
3507,vysvetluje,19,15,4,3554,3369,6257
3508,ovzdusi,19,19,0,3554,2644,49909
3509,rozhodli,19,10,9,3554,5148,2037
3510,chtelo,19,13,6,3554,3915,4187
3511,pouhych,19,13,6,3554,3915,4187
3512,padne,19,16,3,3554,3148,7621
3513,dostaneme,19,18,1,3554,2788,20351
3514,vycviku,19,11,8,3554,4658,2605
3515,poradci,19,11,8,3554,4658,2605
3516,uzavreni,19,14,5,3554,3621,5227
3517,diry,19,8,11,3554,6471,1469
3518,vydaje,19,17,2,3554,2956,10460
3519,svetla,19,12,7,3554,4264,3258
3520,dmitrij,19,12,7,3554,4264,3258
3521,utkani,19,19,0,3554,2644,49909
3522,paradoxne,19,16,3,3554,3148,7621
3523,namornictva,19,9,10,3554,5739,1723
3524,debatu,19,9,10,3554,5739,1723
3525,zvysovani,19,14,5,3554,3621,5227
3526,snazil,19,9,10,3554,5739,1723
3527,zdravim,19,9,10,3554,5739,1723
3528,produkci,19,18,1,3554,2788,20351
3529,dohodnutych,19,19,0,3554,2644,49909
3530,minimum,19,14,5,3554,3621,5227
3531,kosmicke,19,16,3,3554,3148,7621
3532,strankach,19,15,4,3554,3369,6257
3533,prebytky,19,16,3,3554,3148,7621
3534,jadru,19,17,2,3554,2956,10460
3535,sluzbe,19,12,7,3554,4264,3258
3536,rekli,19,15,4,3554,3369,6257
3537,primem,19,14,5,3554,3621,5227
3538,daval,19,10,9,3554,5148,2037
3539,jadernej,19,11,8,3554,4658,2605
3540,and,19,18,1,3554,2788,20351
3541,ekologie,19,18,1,3554,2788,20351
3542,dokazat,19,11,8,3554,4658,2605
3543,povrchu,19,15,4,3554,3369,6257
3544,izolace,19,17,2,3554,2956,10460
3545,starat,19,16,3,3554,3148,7621
3546,korejcum,19,19,0,3554,2644,49909
3547,odvetny,19,17,2,3554,2956,10460
3548,zemedelske,19,12,7,3554,4264,3258
3549,postaveny,19,17,2,3554,2956,10460
3550,mestech,19,16,3,3554,3148,7621
3551,konkurence,19,14,5,3554,3621,5227
3552,aktivity,19,11,8,3554,4658,2605
3553,film,19,13,6,3554,3915,4187
3554,premyslet,19,16,3,3554,3148,7621
3555,japonsku,19,18,1,3554,2788,20351
3556,hezke,19,15,4,3554,3369,6257
3557,vyhorele,19,19,0,3554,2644,49909
3558,vyhoreleho,19,18,1,3554,2788,20351
3559,dejiny,19,15,4,3554,3369,6257
3560,megazakazku,19,19,0,3554,2644,49909
3561,prenosu,19,13,6,3554,3915,4187
3562,financne,19,19,0,3554,2644,49909
3563,prinejmensim,19,13,6,3554,3915,4187
3564,vzkazal,19,16,3,3554,3148,7621
3565,nahradu,19,13,6,3554,3915,4187
3566,socialniho,19,10,9,3554,5148,2037
3567,realna,19,11,8,3554,4658,2605
3568,realneho,19,10,9,3554,5148,2037
3569,polozil,19,15,4,3554,3369,6257
3570,odvete,19,18,1,3554,2788,20351
3571,bludy,19,11,8,3554,4658,2605
3572,mareni,19,18,1,3554,2788,20351
3573,cm,19,15,4,3554,3369,6257
3574,tezsi,19,15,4,3554,3369,6257
3575,hmotnost,19,18,1,3554,2788,20351
3576,automaticky,19,16,3,3554,3148,7621
3577,zbozi,19,18,1,3554,2788,20351
3578,investic,19,18,1,3554,2788,20351
3579,plukovnik,19,8,11,3554,6471,1469
3580,risi,19,9,10,3554,5739,1723
3581,zakazka,19,18,1,3554,2788,20351
3582,mezivladni,19,17,2,3554,2956,10460
3583,objemu,19,13,6,3554,3915,4187
3584,neb,19,18,1,3554,2788,20351
3585,centrum,19,14,5,3554,3621,5227
3586,balistickych,19,14,5,3554,3621,5227
3587,pozvani,19,16,3,3554,3148,7621
3588,inteligenci,19,13,6,3554,3915,4187
3589,promluvil,19,17,2,3554,2956,10460
3590,povazovat,19,15,4,3554,3369,6257
3591,nebezpecny,19,16,3,3554,3148,7621
3592,ukrajinskou,19,10,9,3554,5148,2037
3593,anexi,19,17,2,3554,2956,10460
3594,poli,19,18,1,3554,2788,20351
3595,stavem,19,17,2,3554,2956,10460
3596,srovnavat,19,17,2,3554,2956,10460
3597,zajisteni,19,17,2,3554,2956,10460
3598,dulezitejsi,19,13,6,3554,3915,4187
3599,disponuje,19,18,1,3554,2788,20351
3600,stability,19,15,4,3554,3369,6257
3601,zbytku,19,18,1,3554,2788,20351
3602,mandatu,19,12,7,3554,4264,3258
3603,radiaci,19,17,2,3554,2956,10460
3604,narozeni,19,10,9,3554,5148,2037
3605,narust,19,16,3,3554,3148,7621
3606,slozek,19,9,10,3554,5739,1723
3607,narustu,19,15,4,3554,3369,6257
3608,pozornosti,19,13,6,3554,3915,4187
3609,kapacitu,19,16,3,3554,3148,7621
3610,uspechu,19,11,8,3554,4658,2605
3611,cz,19,14,5,3554,3621,5227
3612,kapacity,19,17,2,3554,2956,10460
3613,zpusobuje,19,19,0,3554,2644,49909
3614,obranne,19,17,2,3554,2956,10460
3615,rezervy,19,18,1,3554,2788,20351
3616,obrane,19,17,2,3554,2956,10460
3617,nastroj,19,15,4,3554,3369,6257
3618,rezimem,19,11,8,3554,4658,2605
3619,vyhrozovat,19,18,1,3554,2788,20351
3620,hluboko,19,12,7,3554,4264,3258
3621,natlaku,19,18,1,3554,2788,20351
3622,preje,19,11,8,3554,4658,2605
3623,echocz,19,18,1,3554,2788,20351
3624,osvetleni,19,8,11,3554,6471,1469
3625,dovoli,19,10,9,3554,5148,2037
3626,zastavi,19,11,8,3554,4658,2605
3627,spojenym,19,11,8,3554,4658,2605
3628,hry,19,17,2,3554,2956,10460
3629,zive,19,16,3,3554,3148,7621
3630,vydela,19,10,9,3554,5148,2037
3631,nesmirne,19,16,3,3554,3148,7621
3632,prubeh,19,11,8,3554,4658,2605
3633,vyslo,19,17,2,3554,2956,10460
3634,kvetnu,19,19,0,3554,2644,49909
3635,netreba,19,15,4,3554,3369,6257
3636,vedeli,19,15,4,3554,3369,6257
3637,dpoved,19,19,0,3554,2644,49909
3638,vysi,19,18,1,3554,2788,20351
3639,klause,19,16,3,3554,3148,7621
3640,kurz,19,14,5,3554,3621,5227
3641,nerealne,19,10,9,3554,5148,2037
3642,chodili,19,6,13,3554,8574,1135
3643,turecka,19,13,6,3554,3915,4187
3644,statech,19,19,0,3554,2644,49909
3645,saudska,19,15,4,3554,3369,6257
3646,agentura,19,14,5,3554,3621,5227
3647,cervene,19,12,7,3554,4264,3258
3648,ostrave,19,9,10,3554,5739,1723
3649,lesu,19,7,12,3554,7377,1282
3650,vraceji,19,12,7,3554,4264,3258
3651,vb,19,13,6,3554,3915,4187
3652,vrati,19,15,4,3554,3369,6257
3653,statnim,19,15,4,3554,3369,6257
3654,navrhuji,18,15,3,3757,3369,7621
3655,vyhlazeni,18,17,1,3757,2956,20351
3656,problemech,18,17,1,3757,2956,20351
3657,hlouposti,18,7,11,3757,7377,1469
3658,investori,18,14,4,3757,3621,6257
3659,revoluci,18,15,3,3757,3369,7621
3660,klasicka,18,13,5,3757,3915,5227
3661,vnitra,18,15,3,3757,3369,7621
3662,cechu,18,17,1,3757,2956,20351
3663,forum,18,17,1,3757,2956,20351
3664,koalice,18,8,10,3757,6471,1723
3665,potravin,18,16,2,3757,3148,10460
3666,osudu,18,12,6,3757,4264,4187
3667,podporovat,18,15,3,3757,3369,7621
3668,fosilnich,18,17,1,3757,2956,20351
3669,zpravu,18,15,3,3757,3369,7621
3670,takovi,18,12,6,3757,4264,4187
3671,projit,18,7,11,3757,7377,1469
3672,ohrozila,18,18,0,3757,2788,49909
3673,zajimat,18,7,11,3757,7377,1469
3674,zenevskych,18,18,0,3757,2788,49909
3675,hromadne,18,15,3,3757,3369,7621
3676,sklady,18,10,8,3757,5148,2605
3677,systemem,18,14,4,3757,3621,6257
3678,prispevky,18,12,6,3757,4264,4187
3679,iransky,18,18,0,3757,2788,49909
3680,kubera,18,1,17,3757,44015,754
3681,narozdil,18,14,4,3757,3621,6257
3682,sluncem,18,9,9,3757,5739,2037
3683,hrozbe,18,13,5,3757,3915,5227
3684,ozbrojenych,18,16,2,3757,3148,10460
3685,zbyvajici,18,9,9,3757,5739,2037
3686,obvinil,18,8,10,3757,6471,1723
3687,sesti,18,18,0,3757,2788,49909
3688,kdesi,18,13,5,3757,3915,5227
3689,slusi,18,3,15,3757,16195,904
3690,bridil,18,12,6,3757,4264,4187
3691,sluzbu,18,16,2,3757,3148,10460
3692,pobliz,18,16,2,3757,3148,10460
3693,opustit,18,14,4,3757,3621,6257
3694,kvoty,18,11,7,3757,4658,3258
3695,iranem,18,18,0,3757,2788,49909
3696,respektovat,18,11,7,3757,4658,3258
3697,plynem,18,13,5,3757,3915,5227
3698,hotovo,18,16,2,3757,3148,10460
3699,obsah,18,8,10,3757,6471,1723
3700,iq,18,13,5,3757,3915,5227
3701,nejspise,18,14,4,3757,3621,6257
3702,pytel,18,4,14,3757,12632,1009
3703,britsky,18,17,1,3757,2956,20351
3704,chlapi,18,9,9,3757,5739,2037
3705,mneli,18,18,0,3757,2788,49909
3706,zbytecna,18,7,11,3757,7377,1469
3707,slovensko,18,16,2,3757,3148,10460
3708,yorku,18,16,2,3757,3148,10460
3709,kazdym,18,17,1,3757,2956,20351
3710,zjistil,18,13,5,3757,3915,5227
3711,mezinarodnich,18,16,2,3757,3148,10460
3712,nasledek,18,17,1,3757,2956,20351
3713,energeticky,18,15,3,3757,3369,7621
3714,prikladem,18,17,1,3757,2956,20351
3715,scenare,18,13,5,3757,3915,5227
3716,silnici,18,7,11,3757,7377,1469
3717,pripraveny,18,8,10,3757,6471,1723
3718,jednotlivce,18,9,9,3757,5739,2037
3719,doopravdy,18,16,2,3757,3148,10460
3720,utrpeni,18,11,7,3757,4658,3258
3721,umluvach,18,18,0,3757,2788,49909
3722,normy,18,16,2,3757,3148,10460
3723,vyrabely,18,15,3,3757,3369,7621
3724,vezme,18,14,4,3757,3621,6257
3725,katastrofu,18,15,3,3757,3369,7621
3726,evidentni,18,11,7,3757,4658,3258
3727,dotaz,18,14,4,3757,3621,6257
3728,ucet,18,16,2,3757,3148,10460
3729,posledniho,18,15,3,3757,3369,7621
3730,citace,18,9,9,3757,5739,2037
3731,dopadl,18,5,13,3757,10298,1135
3732,desti,18,11,7,3757,4658,3258
3733,novinky,18,17,1,3757,2956,20351
3734,sirit,18,17,1,3757,2956,20351
3735,vsimat,18,12,6,3757,4264,4187
3736,poledne,18,8,10,3757,6471,1723
3737,zpracovani,18,16,2,3757,3148,10460
3738,kasy,18,11,7,3757,4658,3258
3739,prubehu,18,15,3,3757,3369,7621
3740,citil,18,3,15,3757,16195,904
3741,uvahu,18,17,1,3757,2956,20351
3742,jednotek,18,17,1,3757,2956,20351
3743,omlouvam,18,12,6,3757,4264,4187
3744,sva,18,12,6,3757,4264,4187
3745,neefektivni,18,17,1,3757,2956,20351
3746,dopadu,18,14,4,3757,3621,6257
3747,pameti,18,13,5,3757,3915,5227
3748,blbec,18,7,11,3757,7377,1469
3749,jednotlive,18,16,2,3757,3148,10460
3750,pusobi,18,16,2,3757,3148,10460
3751,nejbohatsi,18,10,8,3757,5148,2605
3752,utocne,18,14,4,3757,3621,6257
3753,benzinu,18,14,4,3757,3621,6257
3754,afriky,18,12,6,3757,4264,4187
3755,spolecnou,18,14,4,3757,3621,6257
3756,zareagoval,18,8,10,3757,6471,1723
3757,neukoluje,18,18,0,3757,2788,49909
3758,mozku,18,14,4,3757,3621,6257
3759,druhym,18,13,5,3757,3915,5227
3760,saudum,18,14,4,3757,3621,6257
3761,podezreni,18,11,7,3757,4658,3258
3762,rozhoduje,18,14,4,3757,3621,6257
3763,pvo,18,15,3,3757,3369,7621
3764,fuj,18,10,8,3757,5148,2605
3765,navzajem,18,7,11,3757,7377,1469
3766,hodit,18,9,9,3757,5739,2037
3767,policejni,18,12,6,3757,4264,4187
3768,obdobne,18,15,3,3757,3369,7621
3769,poslali,18,12,6,3757,4264,4187
3770,skodu,18,13,5,3757,3915,5227
3771,vytrvale,18,10,8,3757,5148,2605
3772,nocni,18,14,4,3757,3621,6257
3773,necekal,18,10,8,3757,5148,2605
3774,neumite,18,3,15,3757,16195,904
3775,obce,18,14,4,3757,3621,6257
3776,vraha,18,12,6,3757,4264,4187
3777,mixu,18,18,0,3757,2788,49909
3778,obcana,18,10,8,3757,5148,2605
3779,zazil,18,8,10,3757,6471,1723
3780,vodnich,18,16,2,3757,3148,10460
3781,prachu,18,18,0,3757,2788,49909
3782,obama,18,17,1,3757,2956,20351
3783,marsu,18,18,0,3757,2788,49909
3784,pousti,18,10,8,3757,5148,2605
3785,dneskem,18,10,8,3757,5148,2605
3786,firme,18,17,1,3757,2956,20351
3787,touha,18,10,8,3757,5148,2605
3788,zacinam,18,9,9,3757,5739,2037
3789,nepochopil,18,11,7,3757,4658,3258
3790,dejin,18,10,8,3757,5148,2605
3791,modely,18,15,3,3757,3369,7621
3792,namesti,18,10,8,3757,5148,2605
3793,nadeje,18,8,10,3757,6471,1723
3794,klicove,18,17,1,3757,2956,20351
3795,potvrzuje,18,14,4,3757,3621,6257
3796,umime,18,15,3,3757,3369,7621
3797,mil,18,18,0,3757,2788,49909
3798,kampan,18,12,6,3757,4264,4187
3799,soucasnost,18,10,8,3757,5148,2605
3800,prezidentske,18,9,9,3757,5739,2037
3801,zpusobili,18,11,7,3757,4658,3258
3802,zdokonalovanych,18,18,0,3757,2788,49909
3803,spravy,18,18,0,3757,2788,49909
3804,soucast,18,18,0,3757,2788,49909
3805,rozsah,18,10,8,3757,5148,2605
3806,televizni,18,17,1,3757,2956,20351
3807,zisku,18,15,3,3757,3369,7621
3808,httpechocz,18,17,1,3757,2956,20351
3809,firmam,18,12,6,3757,4264,4187
3810,davam,18,14,4,3757,3621,6257
3811,pravdy,18,9,9,3757,5739,2037
3812,valcit,18,16,2,3757,3148,10460
3813,sebemensi,18,7,11,3757,7377,1469
3814,finsko,18,12,6,3757,4264,4187
3815,soci,18,8,10,3757,6471,1723
3816,zlociny,18,10,8,3757,5148,2605
3817,posadky,18,13,5,3757,3915,5227
3818,provozni,18,17,1,3757,2956,20351
3819,poslusne,18,2,16,3757,23102,819
3820,vize,18,17,1,3757,2956,20351
3821,zabery,18,9,9,3757,5739,2037
3822,pomer,18,14,4,3757,3621,6257
3823,princ,18,8,10,3757,6471,1723
3824,snu,18,10,8,3757,5148,2605
3825,vlakem,18,7,11,3757,7377,1469
3826,snizuje,18,15,3,3757,3369,7621
3827,snizovani,18,15,3,3757,3369,7621
3828,nakup,18,16,2,3757,3148,10460
3829,prinesl,18,4,14,3757,12632,1009
3830,nabidnout,18,8,10,3757,6471,1723
3831,nemoci,18,16,2,3757,3148,10460
3832,presvedcit,18,9,9,3757,5739,2037
3833,napadne,18,12,6,3757,4264,4187
3834,cenove,18,16,2,3757,3148,10460
3835,vedoucich,18,6,12,3757,8574,1282
3836,mirne,18,17,1,3757,2956,20351
3837,brani,18,16,2,3757,3148,10460
3838,koule,18,14,4,3757,3621,6257
3839,odstranit,18,10,8,3757,5148,2605
3840,trumpem,18,17,1,3757,2956,20351
3841,zdanlive,18,10,8,3757,5148,2605
3842,ochrana,18,16,2,3757,3148,10460
3843,organizmu,18,18,0,3757,2788,49909
3844,vyvinout,18,13,5,3757,3915,5227
3845,tvrdim,18,12,6,3757,4264,4187
3846,ocima,18,10,8,3757,5148,2605
3847,vrsr,18,10,8,3757,5148,2605
3848,zadnych,18,16,2,3757,3148,10460
3849,uznavam,18,8,10,3757,6471,1723
3850,hovado,18,4,14,3757,12632,1009
3851,jazyk,18,9,9,3757,5739,2037
3852,chodil,18,6,12,3757,8574,1282
3853,nekym,18,8,10,3757,6471,1723
3854,priste,18,13,5,3757,3915,5227
3855,zvitezit,18,17,1,3757,2956,20351
3856,zrusila,18,4,14,3757,12632,1009
3857,strategie,18,16,2,3757,3148,10460
3858,jasnym,18,10,8,3757,5148,2605
3859,jasno,17,13,4,4000,3915,6257
3860,pomuze,17,11,6,4000,4658,4187
3861,agenti,17,14,3,4000,3621,7621
3862,postaveni,17,11,6,4000,4658,4187
3863,duchodu,17,10,7,4000,5148,3258
3864,soukrome,17,14,3,4000,3621,7621
3865,jdete,17,6,11,4000,8574,1469
3866,presidenta,17,7,10,4000,7377,1723
3867,novinaru,17,8,9,4000,6471,2037
3868,ukrajinskym,17,10,7,4000,5148,3258
3869,reagan,17,16,1,4000,3148,20351
3870,kontinentu,17,15,2,4000,3369,10460
3871,pusti,17,6,11,4000,8574,1469
3872,neboli,17,16,1,4000,3148,20351
3873,rocnik,17,9,8,4000,5739,2605
3874,bombardovat,17,15,2,4000,3369,10460
3875,realizaci,17,17,0,4000,2956,49909
3876,cokoli,17,16,1,4000,3148,20351
3877,kontrolu,17,15,2,4000,3369,10460
3878,delnici,17,10,7,4000,5148,3258
3879,informovala,17,15,2,4000,3369,10460
3880,jednodussi,17,17,0,4000,2956,49909
3881,trhy,17,16,1,4000,3148,20351
3882,minulou,17,8,9,4000,6471,2037
3883,konferenci,17,15,2,4000,3369,10460
3884,obchody,17,12,5,4000,4264,5227
3885,bunkr,17,16,1,4000,3148,20351
3886,hodla,17,9,8,4000,5739,2605
3887,umirat,17,8,9,4000,6471,2037
3888,neskutecne,17,8,9,4000,6471,2037
3889,vyzaduje,17,16,1,4000,3148,20351
3890,lehce,17,12,5,4000,4264,5227
3891,zima,17,13,4,4000,3915,6257
3892,poslat,17,12,5,4000,4264,5227
3893,japonska,17,17,0,4000,2956,49909
3894,vlastniho,17,16,1,4000,3148,20351
3895,vychodniho,17,10,7,4000,5148,3258
3896,akumulace,17,12,5,4000,4264,5227
3897,bytost,17,10,7,4000,5148,3258
3898,delnik,17,10,7,4000,5148,3258
3899,rovna,17,14,3,4000,3621,7621
3900,pouzivani,17,15,2,4000,3369,10460
3901,panelaky,17,9,8,4000,5739,2605
3902,bolesti,17,10,7,4000,5148,3258
3903,atomova,17,17,0,4000,2956,49909
3904,eet,17,7,10,4000,7377,1723
3905,lito,17,10,7,4000,5148,3258
3906,dodavaji,17,16,1,4000,3148,20351
3907,zverejneno,17,10,7,4000,5148,3258
3908,japonsko,17,16,1,4000,3148,20351
3909,kritizoval,17,13,4,4000,3915,6257
3910,ztrata,17,12,5,4000,4264,5227
3911,dejme,17,6,11,4000,8574,1469
3912,predstavoval,17,7,10,4000,7377,1723
3913,kone,17,6,11,4000,8574,1469
3914,clena,17,6,11,4000,8574,1469
3915,lisi,17,14,3,4000,3621,7621
3916,vypukne,17,13,4,4000,3915,6257
3917,vydavali,17,5,12,4000,10298,1282
3918,holky,17,7,10,4000,7377,1723
3919,nadrazi,17,14,3,4000,3621,7621
3920,nesnasim,17,9,8,4000,5739,2605
3921,sis,17,10,7,4000,5148,3258
3922,vezmu,17,10,7,4000,5148,3258
3923,procento,17,6,11,4000,8574,1469
3924,rapidne,17,10,7,4000,5148,3258
3925,mensich,17,14,3,4000,3621,7621
3926,elektrarnami,17,17,0,4000,2956,49909
3927,logika,17,15,2,4000,3369,10460
3928,elektrarnam,17,17,0,4000,2956,49909
3929,ducha,17,11,6,4000,4658,4187
3930,clenem,17,15,2,4000,3369,10460
3931,sotva,17,15,2,4000,3369,10460
3932,realnem,17,7,10,4000,7377,1723
3933,vtip,17,11,6,4000,4658,4187
3934,riziku,17,10,7,4000,5148,3258
3935,boze,17,8,9,4000,6471,2037
3936,mym,17,11,6,4000,4658,4187
3937,zlikvidovan,17,4,13,4000,12632,1135
3938,management,17,12,5,4000,4264,5227
3939,slovensku,17,15,2,4000,3369,10460
3940,spolehat,17,13,4,4000,3915,6257
3941,zdi,17,10,7,4000,5148,3258
3942,obsahu,17,14,3,4000,3621,7621
3943,ruznymi,17,16,1,4000,3148,20351
3944,odchodu,17,9,8,4000,5739,2605
3945,emigraci,17,3,14,4000,16195,1009
3946,predsedkyni,17,17,0,4000,2956,49909
3947,zli,17,12,5,4000,4264,5227
3948,vuli,17,15,2,4000,3369,10460
3949,jenz,17,17,0,4000,2956,49909
3950,vyuzivani,17,12,5,4000,4264,5227
3951,vyvolava,17,17,0,4000,2956,49909
3952,pesky,17,9,8,4000,5739,2605
3953,vyuzivaji,17,11,6,4000,4658,4187
3954,platil,17,5,12,4000,10298,1282
3955,primou,17,11,6,4000,4658,4187
3956,korupce,17,11,6,4000,4658,4187
3957,politickymi,17,10,7,4000,5148,3258
3958,pozadavku,17,16,1,4000,3148,20351
3959,iranske,17,17,0,4000,2956,49909
3960,povedou,17,6,11,4000,8574,1469
3961,manevry,17,16,1,4000,3148,20351
3962,zdalo,17,7,10,4000,7377,1723
3963,for,17,15,2,4000,3369,10460
3964,vznikly,17,16,1,4000,3148,20351
3965,politikou,17,13,4,4000,3915,6257
3966,vyberoveho,17,14,3,4000,3621,7621
3967,zrusili,17,13,4,4000,3915,6257
3968,primarne,17,14,3,4000,3621,7621
3969,koupil,17,13,4,4000,3915,6257
3970,ceskoslovenska,17,15,2,4000,3369,10460
3971,vnejsi,17,15,2,4000,3369,10460
3972,dusledek,17,16,1,4000,3148,20351
3973,facto,17,12,5,4000,4264,5227
3974,naprostou,17,14,3,4000,3621,7621
3975,doufejme,17,12,5,4000,4264,5227
3976,kw,17,16,1,4000,3148,20351
3977,mandat,17,8,9,4000,6471,2037
3978,hlavnich,17,16,1,4000,3148,20351
3979,vitezi,17,7,10,4000,7377,1723
3980,tisk,17,8,9,4000,6471,2037
3981,nerikam,17,12,5,4000,4264,5227
3982,smeruje,17,15,2,4000,3369,10460
3983,vver,17,17,0,4000,2956,49909
3984,podari,17,12,5,4000,4264,5227
3985,dcery,17,8,9,4000,6471,2037
3986,dobrej,17,10,7,4000,5148,3258
3987,john,17,16,1,4000,3148,20351
3988,saudove,17,12,5,4000,4264,5227
3989,ucinili,17,7,10,4000,7377,1723
3990,radove,17,15,2,4000,3369,10460
3991,budouciho,17,8,9,4000,6471,2037
3992,miluji,17,9,8,4000,5739,2605
3993,ukladani,17,15,2,4000,3369,10460
3994,kvalitniho,17,11,6,4000,4658,4187
3995,mistnich,17,15,2,4000,3369,10460
3996,magor,17,16,1,4000,3148,20351
3997,interview,17,11,6,4000,4658,4187
3998,povinne,17,13,4,4000,3915,6257
3999,netusim,17,13,4,4000,3915,6257
4000,evropsti,17,8,9,4000,6471,2037
4001,stupne,17,16,1,4000,3148,20351
4002,syna,17,8,9,4000,6471,2037
4003,zachranit,17,15,2,4000,3369,10460
4004,finsku,17,15,2,4000,3369,10460
4005,spotrebuje,17,16,1,4000,3148,20351
4006,bavorsku,17,14,3,4000,3621,7621
4007,zaklad,17,12,5,4000,4264,5227
4008,fotr,17,7,10,4000,7377,1723
4009,cgn,17,17,0,4000,2956,49909
4010,zajmum,17,14,3,4000,3621,7621
4011,neprisel,17,7,10,4000,7377,1723
4012,navsteve,17,7,10,4000,7377,1723
4013,technika,17,13,4,4000,3915,6257
4014,havel,17,9,8,4000,5739,2605
4015,stromy,17,8,9,4000,6471,2037
4016,korunni,17,10,7,4000,5148,3258
4017,sli,17,11,6,4000,4658,4187
4018,mali,17,11,6,4000,4658,4187
4019,pisku,17,8,9,4000,6471,2037
4020,zlocince,17,4,13,4000,12632,1135
4021,vymysli,17,14,3,4000,3621,7621
4022,prevratu,17,14,3,4000,3621,7621
4023,ucinnosti,17,17,0,4000,2956,49909
4024,plutonium,17,16,1,4000,3148,20351
4025,rijadu,17,12,5,4000,4264,5227
4026,koreji,17,13,4,4000,3915,6257
4027,navratu,17,15,2,4000,3369,10460
4028,vina,17,6,11,4000,8574,1469
4029,majetek,17,8,9,4000,6471,2037
4030,odlisne,17,12,5,4000,4264,5227
4031,krasnodarskem,17,7,10,4000,7377,1723
4032,zenu,17,10,7,4000,5148,3258
4033,slabe,17,12,5,4000,4264,5227
4034,snizi,17,16,1,4000,3148,20351
4035,prazaci,17,2,15,4000,23102,904
4036,globalnim,17,15,2,4000,3369,10460
4037,policiste,17,12,5,4000,4264,5227
4038,splnil,17,10,7,4000,5148,3258
4039,jednotlivym,17,11,6,4000,4658,4187
4040,cia,17,15,2,4000,3369,10460
4041,cerneho,17,12,5,4000,4264,5227
4042,pravice,17,9,8,4000,5739,2605
4043,svedsko,17,12,5,4000,4264,5227
4044,rozsahle,17,11,6,4000,4658,4187
4045,drabovou,17,14,3,4000,3621,7621
4046,volat,17,4,13,4000,12632,1135
4047,mmf,17,9,8,4000,5739,2605
4048,vyrobi,17,17,0,4000,2956,49909
4049,neplneni,17,10,7,4000,5148,3258
4050,incidentu,17,16,1,4000,3148,20351
4051,podniknou,17,17,0,4000,2956,49909
4052,poust,17,13,4,4000,3915,6257
4053,nejste,17,13,4,4000,3915,6257
4054,kniha,17,10,7,4000,5148,3258
4055,potvoru,17,9,8,4000,5739,2605
4056,nemohlo,17,15,2,4000,3369,10460
4057,vyraz,17,9,8,4000,5739,2605
4058,podobnym,17,7,10,4000,7377,1723
4059,nemusel,17,12,5,4000,4264,5227
4060,sranda,17,16,1,4000,3148,20351
4061,uzemni,17,12,5,4000,4264,5227
4062,presvedceni,17,12,5,4000,4264,5227
4063,pracuji,17,15,2,4000,3369,10460
4064,nepamatuji,17,7,10,4000,7377,1723
4065,zaminka,17,11,6,4000,4658,4187
4066,spojence,17,17,0,4000,2956,49909
4067,sen,17,13,4,4000,3915,6257
4068,pripravena,17,16,1,4000,3148,20351
4069,psala,17,12,5,4000,4264,5227
4070,podruci,17,17,0,4000,2956,49909
4071,svoboda,17,14,3,4000,3621,7621
4072,cirkev,17,10,7,4000,5148,3258
4073,predpoklada,17,14,3,4000,3621,7621
4074,fyzicke,17,12,5,4000,4264,5227
4075,nezbyva,17,14,3,4000,3621,7621
4076,elektrine,17,14,3,4000,3621,7621
4077,online,17,15,2,4000,3369,10460
4078,nkvd,17,9,8,4000,5739,2605
4079,podobnou,17,15,2,4000,3369,10460
4080,teplota,17,14,3,4000,3621,7621
4081,ozbrojenci,17,12,5,4000,4264,5227
4082,zjednodusene,17,14,3,4000,3621,7621
4083,zili,17,12,5,4000,4264,5227
4084,drahos,17,3,14,4000,16195,1009
4085,bilym,17,8,9,4000,6471,2037
4086,ovce,17,7,10,4000,7377,1723
4087,dnesku,17,17,0,4000,2956,49909
4088,vaclav,17,13,4,4000,3915,6257
4089,argumentu,17,15,2,4000,3369,10460
4090,umyslu,17,7,10,4000,7377,1723
4091,nekolikanasobne,17,17,0,4000,2956,49909
4092,vyraznou,17,8,9,4000,6471,2037
4093,verejnost,17,14,3,4000,3621,7621
4094,hovori,17,16,1,4000,3148,20351
4095,plnit,17,14,3,4000,3621,7621
4096,vydal,17,12,5,4000,4264,5227
4097,tymu,17,8,9,4000,6471,2037
4098,volbam,17,7,10,4000,7377,1723
4099,vystoupit,17,4,13,4000,12632,1135
4100,nejsilnejsi,17,14,3,4000,3621,7621
4101,nezajima,17,12,5,4000,4264,5227
4102,kluk,17,3,14,4000,16195,1009
4103,kolo,17,8,9,4000,6471,2037
4104,moznym,17,8,9,4000,6471,2037
4105,mobilni,17,14,3,4000,3621,7621
4106,kole,17,7,10,4000,7377,1723
4107,nejmensim,17,9,8,4000,5739,2605
4108,trpet,17,12,5,4000,4264,5227
4109,nenavidi,17,10,7,4000,5148,3258
4110,nevylucuje,17,7,10,4000,7377,1723
4111,destnik,17,11,6,4000,4658,4187
4112,nevyhnutelna,17,12,5,4000,4264,5227
4113,libilo,17,8,9,4000,6471,2037
4114,prijel,17,16,1,4000,3148,20351
4115,cdu,17,17,0,4000,2956,49909
4116,jedy,17,15,2,4000,3369,10460
4117,hospodarske,17,15,2,4000,3369,10460
4118,zavadeni,17,13,4,4000,3915,6257
4119,sefuje,17,15,2,4000,3369,10460
4120,sefem,17,8,9,4000,6471,2037
4121,potvrdil,17,10,7,4000,5148,3258
4122,prestali,17,15,2,4000,3369,10460
4123,omylem,17,14,3,4000,3621,7621
4124,nedostane,17,12,5,4000,4264,5227
4125,tzn,17,16,1,4000,3148,20351
4126,pravy,17,13,4,4000,3915,6257
4127,prusvih,17,15,2,4000,3369,10460
4128,jidlo,17,14,3,4000,3621,7621
4129,zvolili,17,11,6,4000,4658,4187
4130,dlouhy,17,12,5,4000,4264,5227
4131,pristavu,17,12,5,4000,4264,5227
4132,chranit,17,16,1,4000,3148,20351
4133,nevadilo,17,9,8,4000,5739,2605
4134,nemuzu,17,9,8,4000,5739,2605
4135,drony,17,12,5,4000,4264,5227
4136,pruzkum,17,14,3,4000,3621,7621
4137,rozvedka,17,12,5,4000,4264,5227
4138,sedet,17,11,6,4000,4658,4187
4139,vykonem,17,15,2,4000,3369,10460
4140,zautoci,17,17,0,4000,2956,49909
4141,starem,16,13,3,4293,3915,7621
4142,brne,16,5,11,4293,10298,1469
4143,nevedi,16,12,4,4293,4264,6257
4144,jest,16,7,9,4293,7377,2037
4145,hledaji,16,16,0,4293,3148,49909
4146,prdel,16,7,9,4293,7377,2037
4147,pritomnosti,16,13,3,4293,3915,7621
4148,ceskem,16,12,4,4293,4264,6257
4149,brity,16,15,1,4293,3369,20351
4150,kdezto,16,15,1,4293,3369,20351
4151,cervna,16,16,0,4293,3148,49909
4152,myslenka,16,15,1,4293,3369,20351
4153,vyplati,16,15,1,4293,3369,20351
4154,istanbulu,16,10,6,4293,5148,4187
4155,peklo,16,12,4,4293,4264,6257
4156,hrozbu,16,12,4,4293,4264,6257
4157,cilene,16,11,5,4293,4658,5227
4158,obraz,16,11,5,4293,4658,5227
4159,dokazuje,16,10,6,4293,5148,4187
4160,rychlost,16,16,0,4293,3148,49909
4161,vrstvy,16,4,12,4293,12632,1282
4162,foru,16,12,4,4293,4264,6257
4163,slysite,16,10,6,4293,5148,4187
4164,tusim,16,13,3,4293,3915,7621
4165,brehu,16,13,3,4293,3915,7621
4166,spousty,16,14,2,4293,3621,10460
4167,hledacku,16,8,8,4293,6471,2605
4168,st,16,16,0,4293,3148,49909
4169,zahajit,16,14,2,4293,3621,10460
4170,udaju,16,14,2,4293,3621,10460
4171,vyplacet,16,10,6,4293,5148,4187
4172,marne,16,12,4,4293,4264,6257
4173,zpusobu,16,15,1,4293,3369,20351
4174,nepsal,16,6,10,4293,8574,1723
4175,dan,16,15,1,4293,3369,20351
4176,poznat,16,11,5,4293,4658,5227
4177,uskupeni,16,12,4,4293,4264,6257
4178,okamura,16,9,7,4293,5739,3258
4179,zbranim,16,15,1,4293,3369,20351
4180,neznam,16,9,7,4293,5739,3258
4181,ussa,16,15,1,4293,3369,20351
4182,patril,16,7,9,4293,7377,2037
4183,ulic,16,6,10,4293,8574,1723
4184,kral,16,5,11,4293,10298,1469
4185,tihle,16,12,4,4293,4264,6257
4186,kazdej,16,12,4,4293,4264,6257
4187,vydava,16,14,2,4293,3621,10460
4188,zna,16,12,4,4293,4264,6257
4189,pc,16,15,1,4293,3369,20351
4190,kliku,16,8,8,4293,6471,2605
4191,elektromobil,16,14,2,4293,3621,10460
4192,jednicku,16,9,7,4293,5739,3258
4193,doktrinu,16,15,1,4293,3369,20351
4194,idiot,16,10,6,4293,5148,4187
4195,asie,16,12,4,4293,4264,6257
4196,demonstraci,16,10,6,4293,5148,4187
4197,startu,16,12,4,4293,4264,6257
4198,vyuzije,16,3,13,4293,16195,1135
4199,plni,16,13,3,4293,3915,7621
4200,andrejbabis,16,16,0,4293,3148,49909
4201,svetem,16,14,2,4293,3621,10460
4202,zamyslet,16,14,2,4293,3621,10460
4203,doletem,16,14,2,4293,3621,10460
4204,radikalni,16,14,2,4293,3621,10460
4205,stretu,16,15,1,4293,3369,20351
4206,zkusil,16,6,10,4293,8574,1723
4207,atomovky,16,10,6,4293,5148,4187
4208,vecech,16,12,4,4293,4264,6257
4209,forme,16,15,1,4293,3369,20351
4210,ohne,16,16,0,4293,3148,49909
4211,ekonomicka,16,14,2,4293,3621,10460
4212,nejmensi,16,13,3,4293,3915,7621
4213,spokojeni,16,8,8,4293,6471,2605
4214,idioti,16,9,7,4293,5739,3258
4215,srandu,16,4,12,4293,12632,1282
4216,slozeni,16,8,8,4293,6471,2605
4217,izolaci,16,16,0,4293,3148,49909
4218,koukam,16,10,6,4293,5148,4187
4219,vyhoda,16,15,1,4293,3369,20351
4220,danou,16,8,8,4293,6471,2605
4221,bank,16,11,5,4293,4658,5227
4222,pomahaji,16,13,3,4293,3915,7621
4223,koncil,16,8,8,4293,6471,2605
4224,pripadna,16,13,3,4293,3915,7621
4225,pozemku,16,13,3,4293,3915,7621
4226,hraji,16,14,2,4293,3621,10460
4227,solary,16,13,3,4293,3915,7621
4228,zatahl,16,8,8,4293,6471,2605
4229,vyhodili,16,7,9,4293,7377,2037
4230,valkach,16,12,4,4293,4264,6257
4231,pripadny,16,16,0,4293,3148,49909
4232,nahoda,16,7,9,4293,7377,2037
4233,bohatych,16,12,4,4293,4264,6257
4234,konzulatu,16,7,9,4293,7377,2037
4235,afganistanu,16,15,1,4293,3369,20351
4236,ziskavani,16,14,2,4293,3621,10460
4237,vlna,16,13,3,4293,3915,7621
4238,vypadat,16,12,4,4293,4264,6257
4239,senatoru,16,9,7,4293,5739,3258
4240,sobotu,16,14,2,4293,3621,10460
4241,ztrati,16,15,1,4293,3369,20351
4242,poloviny,16,14,2,4293,3621,10460
4243,dostaly,16,13,3,4293,3915,7621
4244,recko,16,16,0,4293,3148,49909
4245,vyssich,16,15,1,4293,3369,20351
4246,str,16,16,0,4293,3148,49909
4247,debaty,16,14,2,4293,3621,10460
4248,provokace,16,14,2,4293,3621,10460
4249,mnozstvim,16,14,2,4293,3621,10460
4250,provadet,16,15,1,4293,3369,20351
4251,pomahat,16,13,3,4293,3915,7621
4252,mnohym,16,6,10,4293,8574,1723
4253,vedeny,16,14,2,4293,3621,10460
4254,odstoupit,16,5,11,4293,10298,1469
4255,konkurenci,16,12,4,4293,4264,6257
4256,dobytek,16,12,4,4293,4264,6257
4257,nevsimnout,16,15,1,4293,3369,20351
4258,premysli,16,9,7,4293,5739,3258
4259,jaroslav,16,15,1,4293,3369,20351
4260,merkel,16,11,5,4293,4658,5227
4261,meritku,16,15,1,4293,3369,20351
4262,jaro,16,9,7,4293,5739,3258
4263,soudy,16,7,9,4293,7377,2037
4264,spotrebe,16,13,3,4293,3915,7621
4265,bojuji,16,11,5,4293,4658,5227
4266,zasahnout,16,14,2,4293,3621,10460
4267,rozvoje,16,15,1,4293,3369,20351
4268,stihacky,16,15,1,4293,3369,20351
4269,pil,16,5,11,4293,10298,1469
4270,ostatnimi,16,13,3,4293,3915,7621
4271,vrazdu,16,8,8,4293,6471,2605
4272,upozornil,16,10,6,4293,5148,4187
4273,presvedcuje,16,15,1,4293,3369,20351
4274,zs,16,6,10,4293,8574,1723
4275,zmrazily,16,10,6,4293,5148,4187
4276,nenapise,16,8,8,4293,6471,2605
4277,explozi,16,14,2,4293,3621,10460
4278,podstatny,16,4,12,4293,12632,1282
4279,dohod,16,12,4,4293,4264,6257
4280,venovat,16,14,2,4293,3621,10460
4281,pentagonu,16,14,2,4293,3621,10460
4282,smlouve,16,13,3,4293,3915,7621
4283,ako,16,9,7,4293,5739,3258
4284,nestesti,16,12,4,4293,4264,6257
4285,metra,16,11,5,4293,4658,5227
4286,ocitli,16,8,8,4293,6471,2605
4287,temelinu,16,15,1,4293,3369,20351
4288,smichy,16,7,9,4293,7377,2037
4289,ridici,16,13,3,4293,3915,7621
4290,duvodem,16,14,2,4293,3621,10460
4291,ztraci,16,8,8,4293,6471,2605
4292,power,16,15,1,4293,3369,20351
4293,miroslav,16,15,1,4293,3369,20351
4294,ceskoslovensko,16,14,2,4293,3621,10460
4295,strategicky,16,13,3,4293,3915,7621
4296,spokojen,16,4,12,4293,12632,1282
4297,vznikl,16,10,6,4293,5148,4187
4298,prohlasenim,16,13,3,4293,3915,7621
4299,jaderky,16,14,2,4293,3621,10460
4300,hoven,16,14,2,4293,3621,10460
4301,ochoten,16,8,8,4293,6471,2605
4302,jaderek,16,12,4,4293,4264,6257
4303,vystavi,16,12,4,4293,4264,6257
4304,ocekava,16,15,1,4293,3369,20351
4305,jablek,16,5,11,4293,10298,1469
4306,izraelem,16,14,2,4293,3621,10460
4307,postupu,16,14,2,4293,3621,10460
4308,smlouvou,16,14,2,4293,3621,10460
4309,vymysleli,16,14,2,4293,3621,10460
4310,snazim,16,8,8,4293,6471,2605
4311,hlasat,16,10,6,4293,5148,4187
4312,vladnouci,16,14,2,4293,3621,10460
4313,referendum,16,12,4,4293,4264,6257
4314,reforma,16,10,6,4293,5148,4187
4315,zacinal,16,8,8,4293,6471,2605
4316,minuty,16,14,2,4293,3621,10460
4317,primym,16,8,8,4293,6471,2605
4318,podaril,16,10,6,4293,5148,4187
4319,zide,16,16,0,4293,3148,49909
4320,zvedavy,16,13,3,4293,3915,7621
4321,zada,16,15,1,4293,3369,20351
4322,odejde,16,8,8,4293,6471,2605
4323,odehral,16,9,7,4293,5739,3258
4324,radosti,16,9,7,4293,5739,3258
4325,vyboru,16,14,2,4293,3621,10460
4326,vrazda,16,11,5,4293,4658,5227
4327,bily,16,12,4,4293,4264,6257
4328,sovetskych,16,16,0,4293,3148,49909
4329,urcita,16,8,8,4293,6471,2605
4330,urcitou,16,14,2,4293,3621,10460
4331,generalove,16,16,0,4293,3148,49909
4332,reknete,16,9,7,4293,5739,3258
4333,pozadavky,16,15,1,4293,3369,20351
4334,nezavisle,16,14,2,4293,3621,10460
4335,sovetskym,16,13,3,4293,3915,7621
4336,celit,16,9,7,4293,5739,3258
4337,strategickeho,16,16,0,4293,3148,49909
4338,cinane,16,13,3,4293,3915,7621
4339,nepovedla,16,10,6,4293,5148,4187
4340,miluje,16,6,10,4293,8574,1723
4341,obava,16,10,6,4293,5148,4187
4342,veliky,16,12,4,4293,4264,6257
4343,poslani,16,10,6,4293,5148,4187
4344,su,16,13,3,4293,3915,7621
4345,integrace,16,12,4,4293,4264,6257
4346,kseft,16,12,4,4293,4264,6257
4347,pomohli,16,13,3,4293,3915,7621
4348,pratel,16,8,8,4293,6471,2605
4349,casy,16,12,4,4293,4264,6257
4350,volnost,16,10,6,4293,5148,4187
4351,dukazu,16,15,1,4293,3369,20351
4352,omezene,16,14,2,4293,3621,10460
4353,neberu,16,8,8,4293,6471,2605
4354,uc,16,8,8,4293,6471,2605
4355,pracoval,16,14,2,4293,3621,10460
4356,vikend,16,7,9,4293,7377,2037
4357,jelo,16,8,8,4293,6471,2605
4358,skupinu,16,15,1,4293,3369,20351
4359,skodi,16,8,8,4293,6471,2605
4360,fotky,16,8,8,4293,6471,2605
4361,maj,16,11,5,4293,4658,5227
4362,museji,16,16,0,4293,3148,49909
4363,ucini,16,8,8,4293,6471,2605
4364,svazem,16,13,3,4293,3915,7621
4365,sibir,16,13,3,4293,3915,7621
4366,lekar,16,13,3,4293,3915,7621
4367,troll,16,3,13,4293,16195,1135
4368,dlouheho,16,13,3,4293,3915,7621
4369,nebudete,16,10,6,4293,5148,4187
4370,oskliva,16,1,15,4293,44015,904
4371,domacnosti,16,13,3,4293,3915,7621
4372,surovin,16,14,2,4293,3621,10460
4373,vazeni,16,10,6,4293,5148,4187
4374,propojeni,16,15,1,4293,3369,20351
4375,nedari,16,14,2,4293,3621,10460
4376,invaze,16,10,6,4293,5148,4187
4377,kombinace,16,13,3,4293,3915,7621
4378,mh,16,14,2,4293,3621,10460
4379,vraci,16,8,8,4293,6471,2605
4380,suchy,16,8,8,4293,6471,2605
4381,neprekvapilo,16,16,0,4293,3148,49909
4382,parizi,16,12,4,4293,4264,6257
4383,zradlo,16,8,8,4293,6471,2605
4384,rodine,16,10,6,4293,5148,4187
4385,nechcete,16,11,5,4293,4658,5227
4386,ota,16,10,6,4293,5148,4187
4387,lubomirvolny,16,16,0,4293,3148,49909
4388,ucil,16,3,13,4293,16195,1135
4389,okraj,16,12,4,4293,4264,6257
4390,vyjadrit,16,7,9,4293,7377,2037
4391,ihned,16,13,3,4293,3915,7621
4392,vylozene,16,9,7,4293,5739,3258
4393,listu,16,12,4,4293,4264,6257
4394,statecne,16,11,5,4293,4658,5227
4395,predstavuji,16,15,1,4293,3369,20351
4396,civilizaci,16,16,0,4293,3148,49909
4397,pamatujete,16,10,6,4293,5148,4187
4398,srovnat,16,10,6,4293,5148,4187
4399,placeni,16,12,4,4293,4264,6257
4400,presneji,16,15,1,4293,3369,20351
4401,predstaviteli,16,14,2,4293,3621,10460
4402,prekvapeny,16,6,10,4293,8574,1723
4403,verze,16,12,4,4293,4264,6257
4404,pocitace,16,13,3,4293,3915,7621
4405,uvedeno,16,15,1,4293,3369,20351
4406,necekane,16,7,9,4293,7377,2037
4407,nehody,16,8,8,4293,6471,2605
4408,nechala,16,12,4,4293,4264,6257
4409,muzi,16,11,5,4293,4658,5227
4410,blize,16,14,2,4293,3621,10460
4411,pokusit,16,6,10,4293,8574,1723
4412,pripravil,16,14,2,4293,3621,10460
4413,bezpeci,16,14,2,4293,3621,10460
4414,zajistil,16,9,7,4293,5739,3258
4415,mrtvy,16,6,10,4293,8574,1723
4416,zenska,16,10,6,4293,5148,4187
4417,srn,16,9,7,4293,5739,3258
4418,kolony,16,7,9,4293,7377,2037
4419,hodny,16,7,9,4293,7377,2037
4420,ad,16,15,1,4293,3369,20351
4421,dome,16,13,3,4293,3915,7621
4422,vymenou,16,16,0,4293,3148,49909
4423,schopnych,16,12,4,4293,4264,6257
4424,zkus,16,13,3,4293,3915,7621
4425,stylu,16,14,2,4293,3621,10460
4426,donekonecna,16,4,12,4293,12632,1282
4427,frazi,16,7,9,4293,7377,2037
4428,croplus,16,11,5,4293,4658,5227
4429,vodiku,16,14,2,4293,3621,10460
4430,atomovou,16,14,2,4293,3621,10460
4431,investicni,16,15,1,4293,3369,20351
4432,otazek,16,13,3,4293,3915,7621
4433,objevili,16,15,1,4293,3369,20351
4434,vetsich,16,10,6,4293,5148,4187
4435,nocnim,16,2,14,4293,23102,1009
4436,vyjimkou,16,15,1,4293,3369,20351
4437,zastavaji,16,10,6,4293,5148,4187
4438,dopady,16,15,1,4293,3369,20351
4439,dnesnim,16,14,2,4293,3621,10460
4440,druh,16,13,3,4293,3915,7621
4441,navstevu,16,12,4,4293,4264,6257
4442,skvela,16,6,10,4293,8574,1723
4443,krat,16,16,0,4293,3148,49909
4444,limitu,16,15,1,4293,3369,20351
4445,ladislav,15,15,0,4634,3369,49909
4446,presvedcen,15,13,2,4634,3915,10460
4447,kola,15,6,9,4634,8574,2037
4448,papiru,15,10,5,4634,5148,5227
4449,nesmyslu,15,14,1,4634,3621,20351
4450,zdrazeni,15,15,0,4634,3369,49909
4451,technickych,15,13,2,4634,3915,10460
4452,podstaty,15,14,1,4634,3621,20351
4453,tahne,15,11,4,4634,4658,6257
4454,raduje,15,5,10,4634,10298,1723
4455,nezacala,15,8,7,4634,6471,3258
4456,spojena,15,14,1,4634,3621,20351
4457,ukazali,15,8,7,4634,6471,3258
4458,divize,15,10,5,4634,5148,5227
4459,vyhovovala,15,6,9,4634,8574,2037
4460,pohybu,15,10,5,4634,5148,5227
4461,zranen,15,11,4,4634,4658,6257
4462,zemedelstvi,15,13,2,4634,3915,10460
4463,druzi,15,6,9,4634,8574,2037
4464,lidstvu,15,13,2,4634,3915,10460
4465,tych,15,7,8,4634,7377,2605
4466,onen,15,13,2,4634,3915,10460
4467,vstoupit,15,8,7,4634,6471,3258
4468,erdogan,15,14,1,4634,3621,20351
4469,ukazka,15,6,9,4634,8574,2037
4470,zabavu,15,7,8,4634,7377,2605
4471,mj,15,13,2,4634,3915,10460
4472,vydalo,15,13,2,4634,3915,10460
4473,metody,15,12,3,4634,4264,7621
4474,primy,15,11,4,4634,4658,6257
4475,chuligana,15,5,10,4634,10298,1723
4476,otroctvi,15,2,13,4634,23102,1135
4477,dovozu,15,15,0,4634,3369,49909
4478,vladli,15,6,9,4634,8574,2037
4479,bezplatne,15,5,10,4634,10298,1723
4480,sklenikovych,15,14,1,4634,3621,20351
4481,pudu,15,10,5,4634,5148,5227
4482,vesmes,15,4,11,4634,12632,1469
4483,produkty,15,15,0,4634,3369,49909
4484,smysleni,15,7,8,4634,7377,2605
4485,ryze,15,10,5,4634,5148,5227
4486,sklep,15,7,8,4634,7377,2605
4487,regulovat,15,15,0,4634,3369,49909
4488,smutne,15,9,6,4634,5739,4187
4489,hrubym,15,7,8,4634,7377,2605
4490,in,15,15,0,4634,3369,49909
4491,httpforumczpodlezemanabysedanadrabovanemelaplestdojaderneenergetiky,15,14,1,4634,3621,20351
4492,chvali,15,14,1,4634,3621,20351
4493,kosmickym,15,15,0,4634,3369,49909
4494,milan,15,11,4,4634,4658,6257
4495,gorbacova,15,13,2,4634,3915,10460
4496,odkazu,15,11,4,4634,4658,6257
4497,postavy,15,7,8,4634,7377,2605
4498,havlisticky,15,5,10,4634,10298,1723
4499,boris,15,5,10,4634,10298,1723
4500,matne,15,7,8,4634,7377,2605
4501,zivotniho,15,14,1,4634,3621,20351
4502,reference,15,15,0,4634,3369,49909
4503,vh,15,15,0,4634,3369,49909
4504,referendu,15,13,2,4634,3915,10460
4505,katedre,15,6,9,4634,8574,2037
4506,komunistum,15,3,12,4634,16195,1282
4507,priznivci,15,10,5,4634,5148,5227
4508,vladnou,15,13,2,4634,3915,10460
4509,sergej,15,9,6,4634,5739,4187
4510,vydirani,15,15,0,4634,3369,49909
4511,snaze,15,13,2,4634,3915,10460
4512,hruza,15,11,4,4634,4658,6257
4513,ukor,15,13,2,4634,3915,10460
4514,zranenych,15,8,7,4634,6471,3258
4515,propagandu,15,7,8,4634,7377,2605
4516,celkovy,15,15,0,4634,3369,49909
4517,predpovedi,15,13,2,4634,3915,10460
4518,mzdy,15,9,6,4634,5739,4187
4519,zlocinneho,15,7,8,4634,7377,2605
4520,nedavne,15,15,0,4634,3369,49909
4521,vyhodnoti,15,7,8,4634,7377,2605
4522,vyzkumne,15,15,0,4634,3369,49909
4523,pocitu,15,5,10,4634,10298,1723
4524,prislusne,15,14,1,4634,3621,20351
4525,kusy,15,7,8,4634,7377,2605
4526,azovskeho,15,3,12,4634,16195,1282
4527,zapojeni,15,15,0,4634,3369,49909
4528,garantoval,15,9,6,4634,5739,4187
4529,trvalo,15,12,3,4634,4264,7621
4530,soustavu,15,15,0,4634,3369,49909
4531,odpovednosti,15,9,6,4634,5739,4187
4532,soustavy,15,15,0,4634,3369,49909
4533,josef,15,11,4,4634,4658,6257
4534,dejte,15,11,4,4634,4658,6257
4535,vyzbroje,15,9,6,4634,5739,4187
4536,elitni,15,7,8,4634,7377,2605
4537,rozvijet,15,11,4,4634,4658,6257
4538,ucelove,15,7,8,4634,7377,2605
4539,upozornuji,15,14,1,4634,3621,20351
4540,garanci,15,15,0,4634,3369,49909
4541,vozidla,15,12,3,4634,4264,7621
4542,pravoslavne,15,9,6,4634,5739,4187
4543,ulozeni,15,15,0,4634,3369,49909
4544,exploze,15,14,1,4634,3621,20351
4545,predpokladu,15,13,2,4634,3915,10460
4546,nenecha,15,12,3,4634,4264,7621
4547,pracovnich,15,13,2,4634,3915,10460
4548,minule,15,11,4,4634,4658,6257
4549,zalozena,15,12,3,4634,4264,7621
4550,poslusneho,15,7,8,4634,7377,2605
4551,jednostranne,15,14,1,4634,3621,20351
4552,vypuknuti,15,9,6,4634,5739,4187
4553,citit,15,13,2,4634,3915,10460
4554,vyhodnejsi,15,12,3,4634,4264,7621
4555,standardni,15,11,4,4634,4658,6257
4556,uvedene,15,13,2,4634,3915,10460
4557,herec,15,7,8,4634,7377,2605
4558,stejnym,15,14,1,4634,3621,20351
4559,fatalni,15,13,2,4634,3915,10460
4560,zelenych,15,14,1,4634,3621,20351
4561,httpswwwnovinkyczzahranicnievropaputinhrozievropejadernouodvetouhtml,15,5,10,4634,10298,1723
4562,zeleznicni,15,10,5,4634,5148,5227
4563,delegace,15,6,9,4634,8574,2037
4564,ranu,15,8,7,4634,6471,3258
4565,dostavalo,15,9,6,4634,5739,4187
4566,garantovanou,15,9,6,4634,5739,4187
4567,cetla,15,6,9,4634,8574,2037
4568,souhlasi,15,14,1,4634,3621,20351
4569,teroriste,15,10,5,4634,5148,5227
4570,konstrukci,15,15,0,4634,3369,49909
4571,atmosfery,15,13,2,4634,3915,10460
4572,diskusni,15,7,8,4634,7377,2605
4573,ciziho,15,13,2,4634,3915,10460
4574,odmitla,15,7,8,4634,7377,2605
4575,valecneho,15,10,5,4634,5148,5227
4576,vystaven,15,7,8,4634,7377,2605
4577,nahore,15,14,1,4634,3621,20351
4578,topeni,15,8,7,4634,6471,3258
4579,tvoji,15,7,8,4634,7377,2605
4580,nahradi,15,13,2,4634,3915,10460
4581,expertu,15,15,0,4634,3369,49909
4582,souvisejici,15,14,1,4634,3621,20351
4583,valecny,15,7,8,4634,7377,2605
4584,poskoci,15,10,5,4634,5148,5227
4585,rude,15,12,3,4634,4264,7621
4586,kecu,15,8,7,4634,6471,3258
4587,koncentraku,15,6,9,4634,8574,2037
4588,tvrdou,15,13,2,4634,3915,10460
4589,muceni,15,11,4,4634,4658,6257
4590,telefonu,15,9,6,4634,5739,4187
4591,pomsta,15,7,8,4634,7377,2605
4592,cfd,15,14,1,4634,3621,20351
4593,lesy,15,7,8,4634,7377,2605
4594,realnou,15,9,6,4634,5739,4187
4595,vyjadruje,15,10,5,4634,5148,5227
4596,news,15,14,1,4634,3621,20351
4597,leteckou,15,8,7,4634,6471,3258
4598,normalizaci,15,7,8,4634,7377,2605
4599,zivotem,15,6,9,4634,8574,2037
4600,medialni,15,10,5,4634,5148,5227
4601,pozaduje,15,9,6,4634,5739,4187
4602,valek,15,15,0,4634,3369,49909
4603,konzervativni,15,5,10,4634,10298,1723
4604,silna,15,12,3,4634,4264,7621
4605,plzen,15,13,2,4634,3915,10460
4606,hral,15,14,1,4634,3621,20351
4607,solidni,15,13,2,4634,3915,10460
4608,laboratori,15,13,2,4634,3915,10460
4609,nuklearnim,15,13,2,4634,3915,10460
4610,rozumim,15,5,10,4634,10298,1723
4611,modernizace,15,11,4,4634,4658,6257
4612,presvedcil,15,5,10,4634,10298,1723
4613,prodava,15,10,5,4634,5148,5227
4614,suro,15,3,12,4634,16195,1282
4615,prinese,15,10,5,4634,5148,5227
4616,ucely,15,7,8,4634,7377,2605
4617,prezije,15,11,4,4634,4658,6257
4618,reaguje,15,8,7,4634,6471,3258
4619,vyrobku,15,5,10,4634,10298,1723
4620,kontrakt,15,8,7,4634,6471,3258
4621,necitil,15,6,9,4634,8574,2037
4622,nevzpominam,15,5,10,4634,10298,1723
4623,posileni,15,14,1,4634,3621,20351
4624,instalovali,15,6,9,4634,8574,2037
4625,janda,15,7,8,4634,7377,2605
4626,krutosti,15,6,9,4634,8574,2037
4627,ruskymi,15,11,4,4634,4658,6257
4628,chvilku,15,5,10,4634,10298,1723
4629,smrtelne,15,12,3,4634,4264,7621
4630,pistoli,15,11,4,4634,4658,6257
4631,israel,15,9,6,4634,5739,4187
4632,httpsarchivihnedczcprocmadarskypaksnenivzoremprotemelinruskovedetvrdouinformacnivalkuzadostavbuceskychjadernychelektraren,15,15,0,4634,3369,49909
4633,hledani,15,15,0,4634,3369,49909
4634,sliby,15,12,3,4634,4264,7621
4635,intenzivni,15,13,2,4634,3915,10460
4636,demokraticke,15,11,4,4634,4658,6257
4637,babisem,15,8,7,4634,6471,3258
4638,nezli,15,15,0,4634,3369,49909
4639,skripala,15,11,4,4634,4658,6257
4640,tisku,15,9,6,4634,5739,4187
4641,poslouchat,15,8,7,4634,6471,3258
4642,diplomaticke,15,15,0,4634,3369,49909
4643,komisi,15,14,1,4634,3621,20351
4644,saudsky,15,12,3,4634,4264,7621
4645,budovy,15,12,3,4634,4264,7621
4646,mysleli,15,10,5,4634,5148,5227
4647,dusledkem,15,13,2,4634,3915,10460
4648,objevilo,15,11,4,4634,4658,6257
4649,klasicke,15,13,2,4634,3915,10460
4650,sestreleni,15,15,0,4634,3369,49909
4651,presunu,15,13,2,4634,3915,10460
4652,nedopadne,15,6,9,4634,8574,2037
4653,zakazu,15,7,8,4634,7377,2605
4654,casopisu,15,11,4,4634,4658,6257
4655,marek,15,15,0,4634,3369,49909
4656,dalsimu,15,12,3,4634,4264,7621
4657,kdokoli,15,11,4,4634,4658,6257
4658,trpeli,15,6,9,4634,8574,2037
4659,chapani,15,9,6,4634,5739,4187
4660,poprel,15,9,6,4634,5739,4187
4661,skvely,15,6,9,4634,8574,2037
4662,posilit,15,9,6,4634,5739,4187
4663,evropskeho,15,10,5,4634,5148,5227
4664,tezkych,15,10,5,4634,5148,5227
4665,vyhrozovani,15,15,0,4634,3369,49909
4666,netvrdim,15,13,2,4634,3915,10460
4667,inteligentni,15,8,7,4634,6471,3258
4668,pojem,15,12,3,4634,4264,7621
4669,dosazeni,15,8,7,4634,6471,3258
4670,objektivni,15,11,4,4634,4658,6257
4671,muslimske,15,13,2,4634,3915,10460
4672,casteji,15,6,9,4634,8574,2037
4673,mafie,15,10,5,4634,5148,5227
4674,chystaji,15,12,3,4634,4264,7621
4675,atp,15,13,2,4634,3915,10460
4676,vznikne,15,13,2,4634,3915,10460
4677,vyhlaseni,15,9,6,4634,5739,4187
4678,nejdrazsi,15,13,2,4634,3915,10460
4679,obtizne,15,13,2,4634,3915,10460
4680,doktori,15,5,10,4634,10298,1723
4681,technicka,15,13,2,4634,3915,10460
4682,pyramida,15,9,6,4634,5739,4187
4683,zlata,15,14,1,4634,3621,20351
4684,ceduli,15,7,8,4634,7377,2605
4685,zbyly,15,6,9,4634,8574,2037
4686,preventivne,15,14,1,4634,3621,20351
4687,pluk,15,7,8,4634,7377,2605
4688,nasledku,15,13,2,4634,3915,10460
4689,oznameni,15,15,0,4634,3369,49909
4690,spravnou,15,12,3,4634,4264,7621
4691,pravidlo,15,5,10,4634,10298,1723
4692,vyuzivat,15,11,4,4634,4658,6257
4693,scifi,15,12,3,4634,4264,7621
4694,komousi,15,5,10,4634,10298,1723
4695,zmizi,15,7,8,4634,7377,2605
4696,politickeho,15,7,8,4634,7377,2605
4697,zneuziva,15,9,6,4634,5739,4187
4698,nasobne,15,13,2,4634,3915,10460
4699,severnim,15,13,2,4634,3915,10460
4700,malou,15,8,7,4634,6471,3258
4701,krade,15,10,5,4634,5148,5227
4702,pary,15,9,6,4634,5739,4187
4703,chladici,15,14,1,4634,3621,20351
4704,budov,15,14,1,4634,3621,20351
4705,zbytecny,15,4,11,4634,12632,1469
4706,predstavil,15,5,10,4634,10298,1723
4707,nevedomi,15,9,6,4634,5739,4187
4708,idiotu,15,8,7,4634,6471,3258
4709,spal,15,7,8,4634,7377,2605
4710,kratce,15,11,4,4634,4658,6257
4711,jevi,15,15,0,4634,3369,49909
4712,zavazky,15,14,1,4634,3621,20351
4713,oznacili,15,9,6,4634,5739,4187
4714,cinskou,15,15,0,4634,3369,49909
4715,slovum,15,9,6,4634,5739,4187
4716,nezname,15,9,6,4634,5739,4187
4717,setkavam,15,7,8,4634,7377,2605
4718,asii,15,14,1,4634,3621,20351
4719,takovej,15,8,7,4634,6471,3258
4720,presun,15,15,0,4634,3369,49909
4721,kazdych,15,11,4,4634,4658,6257
4722,myli,15,3,12,4634,16195,1282
4723,federalni,15,10,5,4634,5148,5227
4724,zbroji,15,9,6,4634,5739,4187
4725,moste,15,7,8,4634,7377,2605
4726,nize,15,14,1,4634,3621,20351
4727,komplexu,15,12,3,4634,4264,7621
4728,vojne,15,7,8,4634,7377,2605
4729,stredoveku,15,13,2,4634,3915,10460
4730,pomohla,15,13,2,4634,3915,10460
4731,zadni,15,7,8,4634,7377,2605
4732,slaby,15,5,10,4634,10298,1723
4733,nemcu,15,14,1,4634,3621,20351
4734,data,15,11,4,4634,4658,6257
4735,dnesnich,15,13,2,4634,3915,10460
4736,pocetni,15,7,8,4634,7377,2605
4737,utocnych,15,10,5,4634,5148,5227
4738,arabii,15,12,3,4634,4264,7621
4739,dulezitych,15,8,7,4634,6471,3258
4740,zatez,15,13,2,4634,3915,10460
4741,hlava,15,9,6,4634,5739,4187
4742,zustavaji,15,7,8,4634,7377,2605
4743,mistopredsedu,15,9,6,4634,5739,4187
4744,vyhradne,15,12,3,4634,4264,7621
4745,protiraketove,15,11,4,4634,4658,6257
4746,teploty,15,13,2,4634,3915,10460
4747,nebrani,15,11,4,4634,4658,6257
4748,prestal,15,9,6,4634,5739,4187
4749,generalniho,15,8,7,4634,6471,3258
4750,smesne,15,11,4,4634,4658,6257
4751,vyhrali,15,5,10,4634,10298,1723
4752,prevrat,15,12,3,4634,4264,7621
4753,vymyslel,15,13,2,4634,3915,10460
4754,datum,15,11,4,4634,4658,6257
4755,duvody,15,13,2,4634,3915,10460
4756,doziju,15,7,8,4634,7377,2605
4757,zapotrebi,15,15,0,4634,3369,49909
4758,veskery,15,13,2,4634,3915,10460
4759,odchod,15,8,7,4634,6471,3258
4760,odchazeji,15,13,2,4634,3915,10460
4761,pusu,15,7,8,4634,7377,2605
4762,priklady,15,14,1,4634,3621,20351
4763,znama,15,12,3,4634,4264,7621
4764,plynovodu,15,14,1,4634,3621,20351
4765,dvere,15,7,8,4634,7377,2605
4766,vyucovani,15,6,9,4634,8574,2037
4767,duchody,15,9,6,4634,5739,4187
4768,ridit,15,8,7,4634,6471,3258
4769,zapadnim,15,13,2,4634,3915,10460
4770,dvaceti,15,13,2,4634,3915,10460
4771,dozvedeli,15,4,11,4634,12632,1469
4772,kauze,15,13,2,4634,3915,10460
4773,potencialne,15,15,0,4634,3369,49909
4774,podepsali,15,13,2,4634,3915,10460
4775,oko,15,4,11,4634,12632,1469
4776,benzin,15,14,1,4634,3621,20351
4777,laskave,15,4,11,4634,12632,1469
4778,vedy,15,15,0,4634,3369,49909
4779,podepsana,15,13,2,4634,3915,10460
4780,prehledem,15,7,8,4634,7377,2605
4781,lukas,15,11,4,4634,4658,6257
4782,umite,15,8,7,4634,6471,3258
4783,ukazala,15,12,3,4634,4264,7621
4784,letoun,15,11,4,4634,4658,6257
4785,izraelsky,15,14,1,4634,3621,20351
4786,akcionare,15,15,0,4634,3369,49909
4787,seznam,15,9,6,4634,5739,4187
4788,vcelku,15,7,8,4634,7377,2605
4789,dano,15,13,2,4634,3915,10460
4790,oc,15,8,7,4634,6471,3258
4791,prosla,15,7,8,4634,7377,2605
4792,nelibilo,15,6,9,4634,8574,2037
4793,stylem,15,10,5,4634,5148,5227
4794,predstavitel,15,11,4,4634,4658,6257
4795,komunistech,15,7,8,4634,7377,2605
4796,pude,15,11,4,4634,4658,6257
4797,zahajeni,15,10,5,4634,5148,5227
4798,dilu,15,13,2,4634,3915,10460
4799,musk,15,15,0,4634,3369,49909
4800,okruhu,15,13,2,4634,3915,10460
4801,macron,15,12,3,4634,4264,7621
4802,vydobytky,15,7,8,4634,7377,2605
4803,podivne,15,6,9,4634,8574,2037
4804,iv,15,14,1,4634,3621,20351
4805,dokazete,15,5,10,4634,10298,1723
4806,potaz,15,12,3,4634,4264,7621
4807,haji,15,13,2,4634,3915,10460
4808,bazi,15,15,0,4634,3369,49909
4809,vysvetli,15,11,4,4634,4658,6257
4810,ukrajincu,15,12,3,4634,4264,7621
4811,flotily,15,12,3,4634,4264,7621
4812,fukusima,15,15,0,4634,3369,49909
4813,doprave,15,9,6,4634,5739,4187
4814,lidove,15,8,7,4634,6471,3258
4815,hybridni,15,14,1,4634,3621,20351
4816,ochrane,15,10,5,4634,5148,5227
4817,samotna,15,12,3,4634,4264,7621
4818,klasicky,15,14,1,4634,3621,20351
4819,podobna,15,13,2,4634,3915,10460
4820,prirody,15,11,4,4634,4658,6257
4821,nezda,15,11,4,4634,4658,6257
4822,problematice,14,13,1,5028,3915,20351
4823,dnesniho,14,7,7,5028,7377,3258
4824,naboj,14,5,9,5028,10298,2037
4825,muzika,14,6,8,5028,8574,2605
4826,umoznuje,14,12,2,5028,4264,10460
4827,unikatni,14,7,7,5028,7377,3258
4828,sousedu,14,13,1,5028,3915,20351
4829,spoluzakovi,14,6,8,5028,8574,2605
4830,sousedni,14,14,0,5028,3621,49909
4831,muslimu,14,14,0,5028,3621,49909
4832,dnesnimu,14,6,8,5028,8574,2605
4833,sprosta,14,6,8,5028,8574,2605
4834,bal,14,4,10,5028,12632,1723
4835,pripravit,14,13,1,5028,3915,20351
4836,jednotka,14,7,7,5028,7377,3258
4837,vzniknout,14,10,4,5028,5148,6257
4838,ssm,14,5,9,5028,10298,2037
4839,jenomze,14,13,1,5028,3915,20351
4840,ulohu,14,11,3,5028,4658,7621
4841,poskocil,14,7,7,5028,7377,3258
4842,probihalo,14,14,0,5028,3621,49909
4843,stalinovi,14,8,6,5028,6471,4187
4844,ukolem,14,12,2,5028,4264,10460
4845,extra,14,12,2,5028,4264,10460
4846,dluh,14,11,3,5028,4658,7621
4847,stavenisti,14,14,0,5028,3621,49909
4848,staveni,14,13,1,5028,3915,20351
4849,spionu,14,14,0,5028,3621,49909
4850,dnem,14,8,6,5028,6471,4187
4851,jiskricka,14,6,8,5028,8574,2605
4852,posklebovat,14,9,5,5028,5739,5227
4853,prirodu,14,13,1,5028,3915,20351
4854,divadla,14,6,8,5028,8574,2605
4855,vydirat,14,11,3,5028,4658,7621
4856,ukazu,14,8,6,5028,6471,4187
4857,poslance,14,9,5,5028,5739,5227
4858,mocnost,14,13,1,5028,3915,20351
4859,sprava,14,9,5,5028,5739,5227
4860,srbska,14,13,1,5028,3915,20351
4861,vzpomenou,14,5,9,5028,10298,2037
4862,zabavy,14,6,8,5028,8574,2605
4863,stalinskeho,14,5,9,5028,10298,2037
4864,monopol,14,10,4,5028,5148,6257
4865,vzdelavani,14,13,1,5028,3915,20351
4866,detech,14,6,8,5028,8574,2605
4867,prisly,14,13,1,5028,3915,20351
4868,umela,14,13,1,5028,3915,20351
4869,spolecenskeho,14,4,10,5028,12632,1723
4870,mladeho,14,5,9,5028,10298,2037
4871,posledniskaut,14,10,4,5028,5148,6257
4872,stb,14,4,10,5028,12632,1723
4873,poskytnuti,14,4,10,5028,12632,1723
4874,zmenam,14,7,7,5028,7377,3258
4875,ukazky,14,6,8,5028,8574,2605
4876,mlci,14,7,7,5028,7377,3258
4877,jel,14,12,2,5028,4264,10460
4878,moskvou,14,11,3,5028,4658,7621
4879,minulych,14,12,2,5028,4264,10460
4880,spolupracovat,14,8,6,5028,6471,4187
4881,priznal,14,9,5,5028,5739,5227
4882,pristupu,14,12,2,5028,4264,10460
4883,mysi,14,6,8,5028,8574,2605
4884,zjisti,14,11,3,5028,4658,7621
4885,ministru,14,13,1,5028,3915,20351
4886,stenice,14,6,8,5028,8574,2605
4887,rikame,14,5,9,5028,10298,2037
4888,taborech,14,6,8,5028,8574,2605
4889,lekare,14,7,7,5028,7377,3258
4890,nepotrebuje,14,10,4,5028,5148,6257
4891,schvalila,14,6,8,5028,8574,2605
4892,tvora,14,6,8,5028,8574,2605
4893,chlapce,14,11,3,5028,4658,7621
4894,varovali,14,14,0,5028,3621,49909
4895,nepolozila,14,8,6,5028,6471,4187
4896,popsat,14,9,5,5028,5739,5227
4897,sdelil,14,13,1,5028,3915,20351
4898,syrske,14,11,3,5028,4658,7621
4899,hmoty,14,11,3,5028,4658,7621
4900,nepodaril,14,8,6,5028,6471,4187
4901,nepocita,14,8,6,5028,6471,4187
4902,blizici,14,14,0,5028,3621,49909
4903,lepsiho,14,12,2,5028,4264,10460
4904,les,14,3,11,5028,16195,1469
4905,sebevrazdu,14,13,1,5028,3915,20351
4906,nepovedlo,14,4,10,5028,12632,1723
4907,rikas,14,11,3,5028,4658,7621
4908,vedecke,14,10,4,5028,5148,6257
4909,rim,14,7,7,5028,7377,3258
4910,hodinu,14,12,2,5028,4264,10460
4911,objem,14,14,0,5028,3621,49909
4912,vidis,14,9,5,5028,5739,5227
4913,hod,14,9,5,5028,5739,5227
4914,lasku,14,7,7,5028,7377,3258
4915,pravdepodobnosti,14,12,2,5028,4264,10460
4916,vecera,14,8,6,5028,6471,4187
4917,nerostne,14,14,0,5028,3621,49909
4918,pohyb,14,11,3,5028,4658,7621
4919,sankcim,14,14,0,5028,3621,49909
4920,nepusti,14,13,1,5028,3915,20351
4921,prevzit,14,12,2,5028,4264,10460
4922,apokalypse,14,12,2,5028,4264,10460
4923,blesku,14,6,8,5028,8574,2605
4924,leckdy,14,5,9,5028,10298,2037
4925,led,14,8,6,5028,6471,4187
4926,zeptam,14,11,3,5028,4658,7621
4927,vysledkem,14,12,2,5028,4264,10460
4928,komous,14,3,11,5028,16195,1469
4929,bezneho,14,6,8,5028,8574,2605
4930,choval,14,11,3,5028,4658,7621
4931,qx,14,6,8,5028,8574,2605
4932,vrazi,14,6,8,5028,8574,2605
4933,hloubky,14,8,6,5028,6471,4187
4934,chytit,14,2,12,5028,23102,1282
4935,nejvetsiho,14,7,7,5028,7377,3258
4936,kovy,14,14,0,5028,3621,49909
4937,vnimat,14,11,3,5028,4658,7621
4938,dosah,14,13,1,5028,3915,20351
4939,pachatele,14,14,0,5028,3621,49909
4940,nejrychleji,14,12,2,5028,4264,10460
4941,nejpozdeji,14,12,2,5028,4264,10460
4942,potkam,14,6,8,5028,8574,2605
4943,zavisi,14,14,0,5028,3621,49909
4944,respektcz,14,12,2,5028,4264,10460
4945,obvineni,14,10,4,5028,5148,6257
4946,uzavreny,14,6,8,5028,8574,2605
4947,sferach,14,6,8,5028,8574,2605
4948,sfere,14,5,9,5028,10298,2037
4949,libit,14,12,2,5028,4264,10460
4950,nejelo,14,8,6,5028,6471,4187
4951,nejeli,14,8,6,5028,6471,4187
4952,uznal,14,6,8,5028,8574,2605
4953,hloupejsiho,14,6,8,5028,8574,2605
4954,ozareni,14,13,1,5028,3915,20351
4955,nemuselo,14,8,6,5028,6471,4187
4956,hm,14,5,9,5028,10298,2037
4957,zverejnen,14,4,10,5028,12632,1723
4958,nenarazim,14,6,8,5028,8574,2605
4959,dostavaji,14,9,5,5028,5739,5227
4960,ridic,14,7,7,5028,7377,3258
4961,letat,14,6,8,5028,8574,2605
4962,httpszpravyidnesczputinraketyjadernaodvetaevroparuskousafnozahranicniaspxcazahranicniremy,14,4,10,5028,12632,1723
4963,hlupaka,14,6,8,5028,8574,2605
4964,valci,14,13,1,5028,3915,20351
4965,britum,14,14,0,5028,3621,49909
4966,zenam,14,8,6,5028,6471,4187
4967,poradi,14,12,2,5028,4264,10460
4968,poradili,14,6,8,5028,8574,2605
4969,priciny,14,5,9,5028,10298,2037
4970,vaclava,14,12,2,5028,4264,10460
4971,ovladani,14,12,2,5028,4264,10460
4972,vrstva,14,5,9,5028,10298,2037
4973,ovlivnit,14,13,1,5028,3915,20351
4974,obehu,14,14,0,5028,3621,49909
4975,vozidlo,14,10,4,5028,5148,6257
4976,nejedna,14,10,4,5028,5148,6257
4977,tesi,14,10,4,5028,5148,6257
4978,psalo,14,8,6,5028,6471,4187
4979,cekam,14,3,11,5028,16195,1469
4980,zraneno,14,8,6,5028,6471,4187
4981,nu,14,13,1,5028,3915,20351
4982,aegis,14,12,2,5028,4264,10460
4983,celek,14,12,2,5028,4264,10460
4984,rozpoutani,14,14,0,5028,3621,49909
4985,verbez,14,6,8,5028,8574,2605
4986,tesit,14,11,3,5028,4658,7621
4987,nucenych,14,6,8,5028,8574,2605
4988,venuje,14,14,0,5028,3621,49909
4989,nezapomente,14,12,2,5028,4264,10460
4990,rozsirovani,14,13,1,5028,3915,20351
4991,orbana,14,14,0,5028,3621,49909
4992,kulture,14,4,10,5028,12632,1723
4993,draze,14,13,1,5028,3915,20351
4994,antikomunistickeho,14,6,8,5028,8574,2605
4995,test,14,10,4,5028,5148,6257
4996,pokousel,14,14,0,5028,3621,49909
4997,verici,14,5,9,5028,10298,2037
4998,opravnene,14,11,3,5028,4658,7621
4999,dovolil,14,8,6,5028,6471,4187
5000,rozmistovat,14,10,4,5028,5148,6257
